NM	Never mind
U need to hav ur ID n hope u don't hav any criminal record	you need to have your ID and hope you don't have any criminal record
RTBS	Reason to be single
my sis used my laptop occasionally and she signed in her youtube acc	my sister used my laptop occasionally and she signed in her youtube account
cry and no1 will notice, but is you fart 1c…	Cry and no one will notice,  but is you fart once…
ESAD	Eat Shit And Die
cntrl	control
I try to keep my sources strictly dotgov	I try to keep my sources strictly A government official
LYF	life
BAK	Back At Keyboard
if you can see them, they can CU2 u kno	if you can see them, they can see you too you know
M8	Might
IMNSHO	In My Not So Humble Opinion
got to go BBFN	got to go Bye Bye for now
BTW , what happened to you ppl?	By The Way , what happened to you people?
pmf, but that's fucked up	Pardon my french, but that's fucked up
g2g CWYL	got to go Chat with you later
OBTW	Oh, By The Way
idk y but i like ppl call me by my rl name	I do not know why but i like people call me by my real life name
USBCA	Until something better comes along
Her dress was not beau BSF she is pretty as hell	Her dress was not beautiful but seriously folks she is pretty as hell
pls note I'm not rly related to this fs	please note I'm not really related to this for sure
UOK	Are You okay
Lmmfao Don't Entertain Me Right Now, I'm Drunk Asl	Laughing out loud Don't Entertain Me Right Now, I'm Drunk As Hell
SWALK	Sealed with a loving kiss
NIGI	Now I get it
QL	Quit laughing
BIF	Before I Forget
W	With
PTO	Parent Teacher Organization
TBD	To Be Decided
TTG	Time to go
LTS	Laughing to self
ROTFLTIC	Rolling On The Floor Laughing Till I Cry
Omg I thought my dream was real , I was scared asl	Oh my god I thought my dream was real , I was scared as hell
hi i'm bak and i just yelled at a guy bc i made a driving mistake and he was rude to me abt it	hi i'm back and i just yelled at a guy because i made a driving mistake and he was rude to me about it
when you drive straight home and forget to puks	when you drive straight home and forget to Pick up kids
DIIK	Damned If I Know
BABE SEE U ASAP HA I LUV U	BABE SEE you as soon as possible HA I LOVE you
TSR	Totally Stupid Rules
LTNS	Long time no see
pls CMIIW and do not lie 2 me	please Correct Me If I am Wrong and do not lie to me
TSNF	That's so not fair
Correct Me If I am Wrong but r you going out tn	Correct Me If I am Wrong but are you going out tonight 
my PROGGY works great	my computer program works great
frl	for real
Lmao not till the bday	Laughing out loud not untill the birthday
im kinda sot, plz call me back asasp	im kind of sort of time, please call me back as soon as possible
tbh it's just bc of the haircut and hair color mayb?	to be honest it's just because of the haircut and hair color maybe?
idk if that was a sarcastic thank you but ILY	I do not know if that was a sarcastic thank you but I love you
Q	Queue
When u bumped into ur fave	When you bumped into your favorite
AFAIC	As Far As I am Concerned
JTLYK	Just To Let You Know
aint	are not
Ima crying lyk a baby	I am crying like a baby
cant w8 to take a 3rd pic w you at firefly	cant wait to take a 3rd picture with you at firefly
NHOH	Never Heard Of Him
Oh my God my mom is calling me for dinner so BCNU	Oh my God my mom is calling me for dinner so be seeing you
wut u say?	what you say?
as ur grandma , though idk y im ur grandma , i should tell u the truth	as your grandma , though I do not know why im your grandma , i should tell you the truth
YCHT	You can have them
I got so used to talking to oomf now I just stay up bored asl	I got so used to talking to one of my followers now I just stay up bored as hell
IMA	I will
Y are u so qt	why are you so cutie
YKWIM	You know what I mean
YKW	You know who
U can miss a mf all u want	you can miss a motherfucker all you want
I have 2 crushes here on tw and 1 irl	I have two crushes here on twitter and one in real life
FYA	For Your Amusement
S2R	Send to receive
AWHFY? I will keep ask you that till u say yes	Are We Having Fun Yet? I will keep ask you that untill you say yes
Its Dry Asl	it is dry as hell
BRB	Be Right Back
IMA	I am
gal if you're stalking me rn so pls deal w ur fucking attitude	girl if you're stalking me right now so please deal with your fucking attitude
TF	the fuck
Xlnt work restoring my 1964 LG-1! Thx to Randy Anderson	excellent work restoring my 1964 LG-1! Thanks to Randy Anderson
CULA	See You Later, Alligator
Me 2 bro smh	Me too brother shaking my head
really? You would come with me? Ytg	really? You would come with me? You're the greatest
I will cya there	I will see you there
GA	Go Ahead
PXT	Please explain that
THNX	Thank you
PDS	Please don't shoot
Just got one pl8 bench	just got one plate bench
oomf	one of my friends
TANKING	Owning
TG	Thank goodness
niggas	black men (offensive)
USU	Usually
NFWS	Not for work safe
bye bye CULA	bye bye See you later alligator
THT	Think happy thoughts
well u know what they say, BOHICA	well you know what they say, Bend Over, Here It Comes Again
4	for
DM where it's gone b at	send direct message (on twitter) where it's gone be at
BION	Believe it or not
Watching this movie w lil bro	Watching this movie with lilttle brother
LOLH	Laughing out loud hysterically
IMMA	I Am Going To
me 2	me too
M8 , the only way to be a woman is to be born with XX chromosomes	Mate , the only way to be a woman is to be born with XX chromosomes
IMO	In My Opinion
TLK2UL8R	Talk to you later
Go jam bro lol	go jam brother Laughing Out Loud
At this point I'm wondering just who it is that will even want to run for POTUS in 2020	At this point I'm wondering just who it is that will even want to run for President of the United States in 2020
Lls don't do dat ! Yk imma find someone	Laughing like silly don't do that ! You know I Am Going To find someone
nw it's ur turn	no way it's your turn
SYL sis	See You All Later sister
Bro wtf is wrong with u	Brother what the fuck is wrong with you
bo3	best of three (online gaming)
Yw bro wish you all the best	your welcome brother wish you all the best
Me and Christina tryna convince Nicole to get on Tw is my best thing, honestly YW	Me and Christina trying to convince Nicole to get on Twitter is my best thing, honestly your welcome
Omg tq soo much for doing this	Oh my god I love you (in Spanish) soo much for doing this
IDK	I Do not Know
TQ	I love you (in Spanish)
I just talked to my ex yesterday , she was really pissed cuz i dont pay her child support	I just talked to my former husband (or wife) yesterday , she was really angry because i dont pay her child support
nhoh and nvr heard that story	Never Heard Of Him and never heard that story
THT	that
happy bday u crazy gal	happy birthday you crazy girl
POSSLQ	Person Of Opposite Sex Sharing Living Quarters
PMF	Pardon My French
POAHF	Put on a happy face
XLNT	Excellent
Correct Me If I am Wrong but r you goin out tonight	Correct Me If I am Wrong but are you going out tonight 
SOT	Short of time
real qik	real quick
BFF	Best Friends Forever
WTFE	What the fuck ever
MEGO	My eyes glaze over
i swear man they b annoying af	i swear man they be annoying as fuck
RSVP	reply if you please
also it's really important to feel out how your gut feels wrt how they respond to you	also it's really important to feel out how your gut feels with regard to how they respond to you
homie	friend
an uncrtn future	an uncertain future
i rly can't wait to get rly rly drunk tn n ruin my life	i really can't wait to get really really drunk tonight and ruin my life
voted out bc he is a despicable POS	voted out because he is a despicable Piece Of Shit
ASL	As Hell
IAC	In Any Case
This, I am s2s, is almost entirely wishful thinking	This, I am sorry to say, is almost entirely wishful thinking
VSF	Very sad face
YTB	youtube
Y	Yawn
CU tomorrow bye bye for now	see you tomorrow bye bye for now
ddnt	did not
dis	this
NQA	No Questions Asked
QC	Quality control
MEHH	okay (not satisfied)
TA	take away
TIA	Aunt
thank u ma lovely lysm	thank you my lovely love you so much
GIWIST	Gee, I Wish I had Said That
I'm tryna catch up with ykw	I'm trying to catch up with you know who
I simply love pza so much	I simply love pizza so much
a few ppl can kma after tn	a few people can kiss my ass after tonight
DLTBBB	Do not Let The Bed Bugs Bite
RT	Roger that
I g2g Bye Bye for now	I got to go Bye Bye for now
SK8NG	Skating
We r dumb af n have a asshole coach!	We are dumb as fuck and have a asshole coach!
tn	tonight
RYS	Are you single?
see you tomorrow BBFN	see you tomorrow bye bye for now
DTRT	Do The Right Thing
some1 pls help me i'm in a writing rut	someone please help me i'm in a writing uncomfortable situation (or place)
TMI	Too much information
Ppl associated w the kardashians were my clients today. Fun times, fav job everrrrrrrrr	People associated with the kardashians were my clients today. Fun times, favorite job everrrrrrrrr
Omg I'm so bogus	Oh my God I'm so silly
URW	You are welcome
omg ima tired af	oh my god I am tired as fuck
bro.. pls just stfu	brother.. please just shut the fuck up
BYOB	Bring Your Own Bottle
WYLEI	When you least expect it
SIMYC	Sorry I missed your call
PWN	Own
Bro your dm's aren't open to all	Brother your direct messages (on twitter) aren't open to all
Idk the hype w/ her either lol	I do not know the hype with her either Laughing Out Loud
TOBG	This Oughta Be Good
QFI	Quoted for irony
kim what? Nhoh	kim what? Never Heard Of Her
TKE	take
IZ	is
Like tf I said ... KMA	Like the fuck I said ... Kiss my ass
HAHA OMG Plz lmk if you do	laughing Oh My God Please let me know if you do
imma dm you sis	I am going to send direct message (on twitter) you sister
em	them
i want to hangout w/ u HMU whenever u can	i want to hangout with you hit me up (text me or call me) whenever you can
how can she go out dreesed like this LSHMBA	how can she go out dreesed like this Laughing So Hard My Belly Aches
kinda	kind of
OTTH	On The Third Hand
I luv it so much, it BTHOM	I love it so much, it Beats The Hell Out Of Me
lmao that comment is irrelevant , go back to ur lane or whatever lol	Laughing Out Loud that comment is irrelevant , go back to your lane or whatever Laughing Out Loud
@	at
PDS	Please Do not Shout (typing all in capital letters is rude)
Oh my God my mom is calling me for dinner so BCNU later	Oh my God my mom is calling me for dinner so be seeing you later
I think I'd b a great beauty guru bc I believe in zodiac signs tbh	I think I'd be a great beauty guru because I believe in zodiac signs to be honest
IOW	In Other Words
LQTM literally talked abt how he kinda knew he's too young	Laughing quietly to myself literally talked abt how he kinda knew he's too young
ur a lil late to the party	you are a little late to the party
ur	you are
YA	Your
wtf they are so stupid omfg my stomach hurts from laughing	what the fuck they are so stupid oh my fucking god my stomach hurts from laughing
My ears are ringing lol sos	My ears are ringing laughing out loud help
sry i don't want to annoy everybody	sorry i don't want to annoy everybody
GIAR	give it a rest
you are on twitter although you trying to avoid spoilers?! Mtfbwu	you are on twitter although you trying to avoid spoilers?! may the force be with you (Good luck)
QIK	Quick
K	Okay
W/B	Write back
DIKU	Do I Know You
Man I'm bored asl someone text me or DM me	Man I'm bored as hell someone text me or send direct message (on twitter) me
The film had a lot of potential, but, s2s, it falls flat in just about every way	The film had a lot of potential, but, sorry to say, it falls flat in just about every way
SOS send food and a pillow plz	help send food and a pillow please
he was a sk8r boy she said c u l8r boy	he was a skater boy she said see you later boy
QTPI	Cutie pie
srsly r u doing this on purpose	seriously are you doing this on purpose
His sexy attitude is TMTH for America	His sexy attitude is too much to handle for America
WAN2	Want to
tke cntrl of ure life	take control of your life
lmao I missed your actual bday but happy birthday	Laughing out loud I missed your actual birthday but happy birthday
do not ask me that! Hsik what are you feeling?!	do not ask me that! How Should I Know what are you feeling?!
CYAL8R sis	See You All Later sister
CUL8R bro	See You All Later brother
PIC	Picture
Yw, btw you're so pretty	your welcome, by the way you're so pretty
TAU	Thinking about you
rest of y'all mfs can kma frl	rest of you all motherfuckers can kiss my ass for real
Don't be so curios, piss off and myob	Don't be so curios, piss off and mind your own business
ima stay my ass right mf here	I am a stay my ass right motherfucker here
NT	Nice try
beau	beautiful
yall can have ur own opinions abt him	you all can have your own opinions about him
sup w/ da train	what's up with the train
I Think Now u feel Vry calm aftr listening this news ofc we also feel Vry happy	I Think Now you feel Very calm after listening this news of course we also feel Very happy
fr	for real
im omw wait 4 me plsss	im on my way wait for me please
QQ	cry
PROGGY	computer program
pls no jk lol but srsly no. hahaha	please no just kidding Laughing Out Loud but Seriously no. Laughing
MOMBOY	Mamma's boy
b honest w urself	be honest with yourself
BYKT do not trick me	But You Knew That do not trick me
mom drag me to that show and keep asking me AWHFY	mom drag me to that show and keep asking me Are We Having Fun Yet
hehehe	laughing
istg	I swear to gad
nd	and
YGTBKM	You've got to be kidding me
i want her to cut her hair a lil maybe not just a lil tbh hahaha	i want her to cut her hair a lilttle maybe not just a lilttle to be honest laughing
every new guy I date with is going under qc by my friends	every new guy I date with is going under Quality control by my friends
PIR	Parents in room
TTYS	Talk to you soon
Llhtt yeah Imma talk my shit, but imma be back  	Laughing Too Hard To Type yeah I Am Going To talk my shit, but I Am Going To be back  
CMIIW but r u going out tonight	Correct Me If I am Wrong but are you going out tonight 
WWYC	Write when you can
Her dress was not beautiful but seriously folks she is pretty ASL	Her dress was not beautiful but seriously folks she is pretty as hell
looking good, rys	looking good, are you single?
can't come tonight bc im otw to the hospital	can't come tonight because im on the way to the hospital
Hi bro could u pls follow me back so that I can msg you :)	Hi brother could you please follow me back so that I can message you :)
MOF	Matter Of Fact
yugyeom's story had me rofl oh my lorde btw wyd	yugyeom's story had me Rolling on floor laughing oh my lorde by the way what are you doing
I luv it so much, it Beats The Hell Out Of Me	I love it so much, it Beats The Hell Out Of Me
pls no1 HMU saying united dumb!	please no one hit me up saying united dumb!
How TF do these suburban cats get into the TRAP lyf?! Lyk Y?!	How The Fuck do these suburban cats get into the TRAP life?! Like WHY?!
WUP	What's up
MUAH	Multiple unsuccessful attempts to humor
well me and bff spent valentines day crying w each other wbu	well me and best friend forever spent valentines day crying with each other what about you
betcha	bet you
Hello girlz how r u what r u doing ryt now	Hello girls how are you what are you doing right now
UR2YS4ME	You are too wise for me
4u	for you
I LYSM that it BTHOM	I love you so much that it Beats The Hell Out Of Me
Obviously , just a natural light k baby pls dont envy	Obviously , just a natural light okay baby please dont envy
SOS	Help
frnd	friend
NO1	No one
kpop	korean pop
Ppl r spreading rumours abt u tht u were literate	People are spreading rumours about you that you were literate
idk bro... but lmk when u find something	I do not know brother... but let me know when you find something
ya ikr? i was like , is this pic photoshopped or what...	yeah (yes) I k now right? i was like , is this picture photoshopped or what...
sup frenny , u're talkative and such. i'm lucky to be ur friend , take care x	what's up frenny , you're talkative and such. i'm lucky to be your friend , take care kiss
BCNU	Be seeing you
RLY	Really
just tryna play fortnite w the boyz, wbu	just trying to play fortnite with the boyz, what about you
Y2K	You're too kind
hey there, RUMOF?	hey there, Are you male or female?
I get an award with the carving t4bu	I get an award with the carving Thanks for being you
how much imma spend on food today hhh	how much I am going to spend on food today Laughing
PFT	Pretty fucking tight
Xlnt joke…rofl	excellent joke…Rolling on floor laughing
I am truly hurt fyi	I am truly hurt for your information
got to go B4N	got to go Bye for now
FOAF	Friend Of A Friend
NQT	Newly qualified teacher
S4L	Spam for life
BF	Boyfriend
UKTR	You know that's right
BTAIM	Be That As It May
DI	the
thats all u need to know abt how i'm handling my life rn	thats all you need to know about how i'm handling my life right now
YW	You're welcome
MOO	My own opinion
I am a noob when it comes to love. Lol	I am a Not skilled person when it comes to love. Laughing Out Loud
rtbs no. 129 You don’t have to share your meals	Reason to be single no. 129 You don’t have to share your meals
Lol Man U , Noob	Laughing Out Loud Man You , Not skilled person
ppl start spamming their inbox w this shit	people start spamming their inbox with this shit
looks like alot of ppl want there BF / GF to die lqtm nasty ppl	looks like alot of people want there boyfriend / girlfriend to die Laughing quietly to myself nasty people
Ykw the world is tryna fck with u when u cant find your glasses	You know what the world is trying to fuck with you when you cant find your glasses
ROI	Return on Investment
please don’t make such a BFD out of it	please don’t make such a Big Frickin Deal out of it
MBS	Mom behind shoulder
g2g bye for now	got to go Bye for now
OAUS	On An Unrelated Subject
SSINF	So stupid it's not funny
AFK for a good reason	Away From the Keyboard for a good reason
Y u do that? Why it gotta be like dat?	why you do that? Why it gotta be like that?
RAEBNC	Read And Enjoyed, But No Comment
YD	Yesterday
the big game is tomorrow so BTOBD	the big game is tomorrow so Be There Or Be Dead
fag	gay man (offensive)
W/B	Welcome back
Lol idk why ppl underestimate shit like fame	Laughing Out Loud I do not know why people underestimate shit like fame
ROFLCOPTER	Rolling on floor laughing and spinning around
Lol brb	Laughing out loud be right back
My lil bro is 18	My lilttle brother is 18
r they?? lol but thanks	are they?? Laughing out loud but thank you
how am i? well, n2m	how am i? well, Nothing too much
BRO	brother
happy bday bestie , miss u way too much :( see u soon!! Lysm xxx	happy birthday bestie , miss you way too much :( see you soon!! Love you so much Kisses
i can't deal w the extra haziness i just wan2 cuddle	i can't deal with the extra haziness i just want to cuddle
yeah ppl prolly just project	yeah people probably just project
SPST	Same place, same time
WYGISWYPF	What You Get Is What You Pay For
Why don't you QQ noob	Why don't you cry noob
Oh and btw the mwah mwah is meant for patty	Oh and by the way the kiss kiss is meant for patty
TTUL	Talk to you later
When I send my friend a msg on snapchat but his gf is crazy and opens it	When I send my friend a message on snapchat but his girlfriend is crazy and opens it
OMG I CRS	Oh my God I Can not Remember Shit
g2g Bye Bye for now	got to go Bye Bye for now
OMG we might actually get iKON TV fck i love lyf tnx u god	Oh My God we might actually get iKON TV fuck i love life thanks you god
tff I love that episode on friends	too fucking funnt I love that episode on friends
do ya thing sis	do your thing sister
TBL	Text back later
WNOHGB	Where No One Has Gone Before
Still so in luv w Goblin's OST	Still so in love with Goblin's original soundtrack
got to go, ttyl	got to go, talk to you later
TBD	To be determined
Yes, AAMOF, I saw it that movie day it came out	Yes, As a matter of fact, I saw it that movie day it came out
SOB	Stressd Out Bigtime
u ever see a pic of yourself n be like damn that's fucking awful	you ever see a picture of yourself and be like damn that's fucking awful
LSHMBH	Laughing So Hard My Belly Hurts
STFU	Shut the fuck up
NRN	No response / reply necessary
LULZ	Laugh out loud
OST	original soundtrack
ONNTA	Oh No, Not This Again
idk u but we follow each other so we're family lol	I do not know you but we follow each other so we're family laughing out loud
CYAL8R bro	See You All Later brother
boi	boy
LOTI I thought that was funny	Laughing on the inside I thought that was funny
BYOB to the party next month	Bring Your Own Bottle to the party next month
IJWTK	I Just Want To Know
ASAYGT	As Soon As You Get This
I wiLL luv U 4 ever	I will love you forever
AWTTW	A Word To The Wise
would ppl like to see some of my sketches on here idk but who rly cares	would people like to see some of my sketches on here I do not know but who really cares
Plz DM with your email address	Please send direct message (on twitter) with your email address
BTW	By The Way
OMDB	Over my dead body
You are a lying scumbag POS	You are a lying scumbag Piece Of Shit
4 u	for you
obv	obviously
Local PD will be involved as well	Local Police department will be involved as well
Yeah bro wtf lmk	Yeah brother what the fuck let me know
DOTGOV	A government official
OBO	Or Best Offer
JK	Just Kidding
UNA	Use no acronyms
YBYSA	You Bet Your Sweet Ass
why do yttl to ask her to marry you?	why do you take too long to ask her to marry you?
I'm nt here for ur Q&A...ask Google!	I'm not here for your question and answer...ask Google!
my mom bought me playstation! Mom ytg!	my mom bought me playstation! Mom You're the greatest!
OATUS	On a totally unrelated subject
W/	With
CU tomorrow B4N	see you tomorrow bye for now
Bring Your Own Bottle to tha party next month	Bring Your Own Bottle to the party next month
Yw sis loving the look so much	Your welcome sister loving the look so much
SIG2R	Sorry, I got to run
S2S	Sorry to say
slick	(acting) perfect
OIB	Oh, I'm back
looking at you sleeping this morning and thinking how lucky I am t4bu	looking at you sleeping this morning and thinking how lucky I am Thanks for being you
how am i? well, nm	how am i? well, Nothing much
L8R	Later
Omg rly?! Dm me how you been maintaining it	Oh my god really?! send direct message (on twitter) me how you been maintaining it
happy bday 2 the most talented most amazing person i kno	happy birthday to the most talented most amazing person i know
g2g TTFN	got to go Bye Bye for now
I CRS	I Can not Remember Shit
No its just ur a lazy shit lol	No its just you are a lazy shit Laughing Out Loud
dm	send direct message (on twitter)
hi, my name is jessucs I'm from Queens. Wuf	hi, my name is jessucs I'm from Queens. Where are you from?
TFS	Thanks for sharing
ty very much ur sweet	thank you very much you are sweet
Nvr thought i'd be the kinda gal to like cars	Never thought i'd be the kind of girl to like cars
IMHO simplistically ur “growing faster”	in my humble opinion simplistically you are “growing faster”
What is happening to that noob lol	What is happening to that Not skilled person Laughing Out Loud
no1 I hit up don't feel like talking 2 me 2 early	no one I hit up don't feel like talking to me too early
bc niggas been hmu tryna ask me out	because niggas been hit me up (text me or call me) trying to ask me out
TMI BUT PLS PLS DON'T LET ME TAKE THESE EVER AGAIN , THE BOX SAYS GENTLE RELIEF BUT I JUST DESTROYED A TOILET	Too Much Information BUT please please DON'T LET ME TAKE THESE EVER AGAIN , THE BOX SAYS GENTLE RELIEF BUT I JUST DESTROYED A TOILET
S'OK	It's okay
LMS	Like my status (Facebook)
NTIMM	Not That It Matters Much
I rlly luv his sc stories	I really love his snapchat stories
PSOS	Parent standing over shoulder
keep me posted w da jobs	keep me posted with the jobs
Just got 1 plate bench	just got one plate bench
y dont u dm the owner	Why dont you send direct message (on twitter) the owner
RMLB	Read my lips baby
you know how they alwayes say st&d? they are right. Stop doing it.	you know how they alwayes say Stop texting and drive? they are right. Stop doing it.
Wtf does this even mean lol	What the fuck does this even mean Laughing out loud
TC	Take care
sat	sitting
Wishing u a Vry vry Greatttt Happy Bday	Wishing you a Very very Greatttt Happy Birthday
LOTI	Laughing on the inside
idk ttyl. ily	i do not know talk to you later. i love you
TL	Timeline (twitter)
Her dress Wazznt beau BSF she is pretty ASL	Her dress was not beautiful but seriously folks she is pretty as hell
the big game iz tomorrow so BTOBD	the big game is tomorrow so Be There Or Be Dead
Just QQ already	just cry already
it will change ur whole lyf yw	it will change your whole life your welcome
idk why but i thought this	I do not know why but i thought this
oh w8 nvm lol	oh wait never mind laughing out loud
SUP	What's up
YTB	You're the best
Idk why ppl wait last min to hmu	I do not know why people wait last min to hit me up (text me or call me)
remember that Dumb and Dumber movie? Ssif	remember that Dumb and Dumber movie? so stupid it's funny
LMAO	Laughing out loud
all u ppl who dont follo me bak r really immature	all you people who dont follow me back are really immature
TBYB	Try Before You Buy
OFC	of course
CU tomorrow BFN	see you tomorrow bye for now
happy bday lil baby we been talking bout this day since New Years	happy birthday lilttle baby we been talking about this day since New Years
FYI providing I don't violate Twitter's TOS	For Your Information providing I don't violate Twitter's Terms of service
lmk what u turn up pls	let me know what you turn up please
LMMFAO	Laughing out loud
IWBNI	It Would Be Nice If
Pls dnt judge the wig slip xoxo	Please do not judge the wig slip Kisses and Hugs
YHBT	You have been trolled
U choose ur decision imco	you choose your decision in my Considered opinion
stfu cuz McDonald's fries r better	shut the fuck up because McDonald's fries are better
ssinf I hate his vids	So stupid it's not funny I hate his videos
CSG	Chuckle, Snicker, Grin
WUF	Where are you from?
YGG	You go girl
UDM	You the man
1c upon a time ily 4ever	once upon a time I love you forever
i dont follow u but ur account looks cute and im happy u follow me mwah	i dont follow you but your account looks cute and im happy you follow me kiss
Correct Me If I am Wrong but r you goin out 2nite	Correct Me If I am Wrong but are you going out tonight 
MOS	Mother over shoulder
omg i love ur acct	oh my god i love your account
SW8	sweet
BSF	but seriously folks
SWL	Screaming with laughter
ask her out already yttl man	ask her out already You take too long man
PPL	People
YBS	You'll be sorry
yeah ppl prolly just project n then just protest abt tht	yeah people probablly just protest and then just forget about that
PUKS	Pick up kids
LOLWTF	Laughing out loud and saying What the fuck
tfw	That feeling when
iyo	in your opinion
as a lil gal I wanted my Prince Charming to find me on a walk in the woods lol	as a little girl I wanted my Prince Charming to find me on a walk in the woods laughing out loud
OTOOH	On The Other Other Hand
they gone have to ask God , and stop tryna harass me bout these niggas	they gone have to ask God , and stop trying to harass me about these black men (offensive)
PMBI	Pardon My Interfering
m8 get in touch n may b able to help u out	mate get in touch and may be able to help you out
YTG	You're the greatest
wants to have pza later?	wants to have pizza later?
SCNR	Sorry, Could Not Resist
JC	Just Chilling
IKYABWAI	I Know You Are But What Am I
WU	What's up
can you stfu n leave em alone wtf	can you shut the fuck up and leave them alone what the fuck
His sexy attitude is 2M2H for America	His sexy attitude is too much to handle for America
OJ	Only joking
it always have to be a vid kind of dm	it always have to be a video kind of send direct message (on twitter)
CU	See You
A lot of it wrt literature, especially Modern Literature	A lot of it With regard to literature, especially Modern Literature
LMBO he knows we have a "love / hate" relationship luv ya sis	laughing out loud he knows we have a "love / hate" relationship love you sister
TOS	Terms of service
IMHO	In My Humble Opinion
really? You would come with me? Ytb	really? You would come with me? You're the best
Lol guessing u dnt stay behind for post credits	Laughing out loud guessing you do not stay behind for post credits
CUL8R	See You Later
U-L	You will
aisi, we need to move by the end of the month	As I see it, we need to move by the end of the month
When you hug someone n ur head is below their shoulder wtf do u do w ur head	When you hug someone and your head is below their shoulder what the fuck do you do with your head
TANJ	There is not Justice
HHTYAY, have a safe weekend!	Happy Holidays to You and Yours, have a safe weekend!
Is it XLR8 even better in the reboot?	Is it excelerate even better in the reboot?
There is a great sale going on at the store, most under $10, but YMMV	There is a great sale going on at the store, most under $10, but Your mileage may vary
L	Laugh
Ngl , sometimes I'm srsly annoying	Not going to lie , sometimes I'm seriously annoying
UT2L	You take too long
i wanna research and see the real ppl behind it bc its based on a true story omg	i wanna research and see the real people behind it because its based on a true story oh my god
okie i rly need a new phone cause after the update my phone keeps crashing and it has TONS OF BUGS WTF	okie i really need a new phone because after the update my phone keeps crashing and it has TONS OF BUGS What The Fuck
Ya	yeah (yes)
you always assume I kno all those ppl but actually nhoh	you always assume I know all those people but actually never heard of him
LYLAB	Love You Like A Brother
YAUN	Yet Another Unix Nerd
MFS	motherfucker
FOAG	Fuck Off And Google
Her dress was not beautiful BSF she is pretty ASL	Her dress was not beautiful but seriously folks she is pretty as hell
DQMOT	do not quote me on this
dz'nt	does not
If it wasn't a dotgov I don't want to hear about it	If it wasn't a government official I don't want to hear about it
ma	my
fave	favorite
FOAD	Fuck off and die
WIBNI	Would not it be nice if
Me LTS as I was introducing myself	Me Laughing to self as I was introducing myself
i had to do a double take on winwin bc i thought he was hyuck for a sec ngl	i had to do a double take on winwin because i thought he was hyuck for a second not going to lie
SOWM	Someone with me
Stfu boi cuz ur profile pic is ugly af	Shut the fuck up boy because your profile picture is ugly as fuck
OTP	On the phone
SS	So sorry
omg ofc I will help u w dat	oh my god of course I will help you with that
istg , i m8 punch u	I swear to gad , i might punch you
PLS LMK IF I CAN DM U	Please Let me know IF I CAN send direct message (on twitter) you
ofc Ima see you later ty	of course I will see you later thank you
ya, you came but you act like sot and not so present	yeah (yes), you came but you act like sort of time and not so present
YGTBK	You have Got To Be Kidding
Q&A	question and answer
LMAO WYD DORO YA IDIOT	laughing out loud what are you doing doro you idiot
hoping 4 You players 2 b even much more effective	hoping for You players to be even much more effective
AYOR	At Your Own Risk
hhh thank u	laughing thank you
Sry sry behalf of her I said sry I know she wuz wrong	Sotry sorry behalf of her I said sorry I know she was wrong
CWYL	Chat With You Later
I just bought new sheets with pza print	I just bought new sheets with pizza print
ily too	I love you too
SFAIK	So far as I know
gr8	great
till	untill
I do not know, uncrtn bout it	I do not know, uncertain about it
ISS	I am So Sure
KMIA	Kiss My Italian Ass
GG	Good Game
bored asl , somebody hmu or something lol	bored as hell , somebody hit me up (text me or call me) or something Laughing Out Loud
ROTFLOL	Rolling On The Floor Laughing Out Loud
TTYAFN	Talk to you a while from now
PU	That stinks
AAMOF, there is no substance to that rumor	As a matter of fact, there is no substance to that rumor
BFD	Big Frickin Deal
rtbs no. 451 You never have to clear your browsing history	Reason to be single no. 451 You never have to clear your browsing history
no1 wants 2b left out	no one wants to be left out
imma just say FUCK YA SIS	I am going to just say FUCK YEAH (yes) SISTER
stfu let me pinch his cute lil dimples	shut the fuck up let me pinch his cute lilttle dimples
what will Sundays evening b lyk w/o ya	what will Sundays evening be like without you
I know you will not listen to me so all I can do now is to wish you mtfbwu	I know you will not listen to me so all I can do now is to wish you may the force be with you (Good luck)
pls don’t make such a BFD out of it	please don’t make such a Big Frickin Deal out of it
He funny asl	He is funny as hell
Whole lotta letters	Whole lot of a letters
tha	the
ok girl, TLK2UL8R	ok girl, talk to you later
MTFBWU	May the force be with you (Good luck)
Sup hoss , I saw ur post and thought , "Wow , what a tweet."	what's up hoss , I saw your post and thought , "Wow , what a tweet."
4ever	forever
Lolh Idk why he said this cuz they prolly won't	Laughing out loud hysterically I do not know why he said this because they probably won't
acc	account
Why r u talking lmao	Why are you talking Laughing out loud
WC	Who cares
XOXO	Kisses and Hugs
this gal is all good but she's a noob	this girl is all good but she's a Not skilled person
doe	though
GTSY	Great To See You
RHIP	Rank has its privileges
UNBLEFBLE	Unbelievable
Yrw sis loving the look so much	You are welcome sister loving the look so much
TBC	To be continued
RT	Retweet (Twitter slang)
can u imagine being abt to sleep w someone and ur lyk “im 18. wbu” and theyre lyk “im 19” and u get off to that	can you imagine being about to sleep with someone and you are like “im 18. what about you” and theyre like “im 19” and you get off to that
PLS	Please
POTUS	President of the United States
ROTFLMAOTID	Rolling On The Floor Laughing My Ass Off Till I Die
vines are gr8 , that is a fact m8	vines are great , that is a fact mate
lmk pls	let me know please
gal	girl
I g2g so I will CWYL	I got to go so I will Chat with you later
wat r u wearing???	what are you wearing?
PDH	Very happy
VSC	Very soft chuckle
She didn't mean $40 Sis ... Step ya game up	She didn't mean $40 Sister ... Step your game up
ltm and i'm not even interested in tht fml	Laughing To Myself and i'm not even interested in that fuck my life
coz I wudnt wanna msg u to start explaining why I ddnt reply ur chat	because I would not wanna message you to start explaining why I did not reply your chat
CSG is Used to express a light hearted laugh	Chuckle, Snicker, Grin is Used to express a light hearted laugh
VRY	Very
KMA	Kiss My Ass
WTF ily i dont think that at all	what the fuck I love you i dont think that at all
OTB	Off to bed
danny I am trying to call you! wru@?	danny I am trying to call you! Where are you at?
PCM	Please call me
no doubt idk what yall are smokin	no doubt I do not know what you all are smoking
4 me	for me
HHOJ	Ha Ha Only Joking
NALOPKT	Not a lot of people know that
veg ppl save a lot of money compared to non veg counterparts	vegetarian people save a lot of money compared to non vegetarian counterparts
QFE	Question for everyone
ok honestly im rt-ing bc it's funny idk what's going on lmao	okay honestly im Retweet-ing because it's funny I do not know what's going on Laughing out loud
my tl is dead!!!	my time line (twitter) is dead!!!
how do u ppl come across ppl who have u blocked	how do you people come across people who have you blocked
YAOTM	Yet Another Off-Topic Message
pls do NOT learn japanese from my tl cause my japanese is rlly bad	please do NOT learn japanese from my Timeline (twitter) because my japanese is really bad
MMK	Mmm, okay
U choose ur decision imo	you choose your decision in my opinion
YIWGP	Yes, I Will Go Private
rlly rlly rlly wanna learn how to snowboard. Sos	really really really wanna learn how to snowboard. Help
SK8	Skate
TTLY	Totally
PFT	An exlamation of disbelief
sc did something i like for once wow , surprisingly i rlly like the gif feature they got	snapchat did something i like for once wow , surprisingly i really like the gif feature they got
idk wtf really went down bc that vid was SHIT	I do not know what the fuck really went down because that video was SHIT
IIABDFI	If It is not Broken Do not Fix It
B4N	Bye For Now
Her dress Wazznt beau but seriously folks she is pretty ASL	Her dress was not beautiful but seriously folks she is pretty as hell
Lmao Don't Entertain Me Right Now , I'm Drunk Asl	Laughing out loud Don't Entertain Me Right Now , I'm Drunk As Hell
Ladys lyk u are vry few	Ladys like you are very few
aftr	after
and then he just said "ttyl gal" with a wink!	and then he just said "talk to you later girl" with a wink!
CMIIW but r you going out tn	Correct Me If I am Wrong but are you going out tonight 
YSYD	Yeah sure you do
VGC	Very good condition
y r u nt welcomed in d US?	why are you not welcomed in the US?
TFTHAOT	Thanks For The Help Ahead Of Time
you are my hero, when you talks I hoyew	you are my hero, when you talks I Hanging On Your Every Word
OOTD	One of these days
YGWYPF	You Get What You Pay For
FS	For Sure
NOYB	None of your business
WAG	Wild Assed Guess
Her dress Wazznt beau BSF she is pretty as hell	Her dress was not beautiful but seriously folks she is pretty as hell
H&K	Hugs and Kisses
pissed	angry
Bartenders are either cool af or rude asl , there is NO in between	Bartenders are either cool as fuck or rude as hell , there is no in between
tbh this will rly make me happy on my bday	to be honest this will really make me happy on my birthday
Oh ok LOL yd u said u were beth	Oh ok Laughing Out Loud yesterday you said you were beth
rtbs no. 32 You don’t have to plan a wedding	Reason to be single no. 32 You don’t have to plan a wedding
I want a style atsl for my own wedding	I want a style along the same line for my own wedding
the marathon has forced me to come ftf with my physical limitations	the marathon has forced me to come face to face with my physical limitations
NIROK	Not in reach of keyboard
Bc he is a POS liberal who break laws for their own benefit	Because he is a Piece Of Shit liberal who break laws for their own benefit
Kinda what I'm doin already but I'll try youtube as well , thx m8	Kind of what I'm doing already but I'll try youtube as well , thanks mate
oh my god I CRS	Oh my God I Can not Remember Shit
JFI	Just For Information
JAS	Just A Second
idk what to think abt this drawing tbh	I do not know what to think about this drawing to be honest
BBL	Be Back Later
well YKW they say, BOHICA	well you know what they say, Bend Over, Here It Comes Again
NOOB	Not skilled person
u kno I do this 4u	you know I do this for you
S	Smile
DWIMNWIS	Do What I Mean, Not What I Say
XX	Kisses
I got to go CWYL	I got to go Chat with you later
I ttly fell down the stairs right in front of my crush. It wuz TMTH	I totally fell down the stairs right in front of my crush. It was too much to handle
STFU or QQ	Shut the fuck up or cry
TTYL	Talk to you later
UCMU	You crack me up
idk ur just rly needy	I do not know you are just really needy
Need a team for today ASAP	Need a team for today as soon as possible
this guy is tryna follo me on Instagram with 3 different accounts, send me a dm, and added me on sc too wtf	this guy is trying to follow me on Instagram with 3 different accounts, send me a send direct message (on twitter), and added me on snapchat too what the fuck
RL	Real life
lts You bday but we have 0 pics so happy bday sis	lts You birthday but we have 0 pictures so happy birthday sister
PL8	Plate
nhoh and nvr heard that story	Never Heard Of Her and never heard that story
WC	Welcome
WDYT	What do you think
don't judge a book by its cover IYSWIM	don't judge a book by its cover If You See What I Mean
Her dress was not beautiful BSF she is pretty as hell	Her dress was not beautiful but seriously folks she is pretty as hell
OOC	Out of character
oh ya forgot to say im in the library btw w/o my phone	oh yeah (yes) forgot to say im in the library by the way without my phone
hey qt idk u but wine&dine???	hey cutie I do not know you but wine&dine???
Her dress was not beau but seriously folks she is pretty as hell	Her dress was not beautiful but seriously folks she is pretty as hell
pls Correct Me If I am Wrong	please Correct Me If I am Wrong
omg Rell your such a guy girl get tf out my face u ain't touching my paper	oh my god Rell your such a guy girl get the fuck out my face you ain't touching my paper
u ask for my opinion so there it is: IMNSHO, u have great voice but u not a good composer	you ask for my opinion so there it is: In My Not So Humble Opinion, you have great voice but you not a good composer
i'm gonna make a private acct so lms if u want it	i'm gonna make a private account so Like my status (Facebook) if you want it
PITA	Pain in the ass
Omg this yg so cute! I took him with my bf to playing vid games	Omg this young gangster so cute! I took him with my boyfriend to playing video games
RUT	Are you there
For sure getting 2 tatts ASAP	For sure getting two tattoo as soon as possible
TAKS	That is a knee slapper
if ur afraid 2 die, u hav alredy died	if you are afraid to die, you have alredy died
1 of my fave	one of my favorite
gosh	gad
LNT	Meaning lost in translation
RIP Poor lil guy	rest in peace poor little guy
hey becky can we meet ftf?	hey becky can we meet face to face?
we all kno u r good n honest person	we all know you are good and honest person
oh dad idk how many times i must tell u im not interested in football	oh dad I do not know how many times i must tell you im not interested in football
school, work, family, friendship AND relationship… that's 2M2H	school, work, family, friendship AND relationship… that's too much to handle
GAS 2U	Greetings and Salutations to you
YYSSW	Yeah, yeah, sure, sure, whatever
ROTF	Rolling On The Floor
idk n not rly care with the time but y?	I do not know and not really care with the time but why?
UTM	You tell me
Her dress Wazznt beautiful but seriously folks she is pretty as hell	Her dress was not beautiful but seriously folks she is pretty as hell
this was a BWQ	this was a Buzz Word Quotient
Just got 1 pl8 bench	just got one plate bench
LLTA	Lots and Lots of Thunderous Applause
You can't park here! Orly	You can't park here! Oh really?
LoL ya feel me bro	Laughing out loud you understand me brother
Its early af	Its early as fuck
u can dm me anytime	you can send direct message (on twitter) me anytime
SMOP	Small Matter of Programming
follo	follow
EOL	End of Life
UFB	Un fucking believable
why do you insists on going there alone? Mtfbwu	why do you insists on going there alone? May the force be with you (Good luck)
FURTB	Full Up Ready To Burst
Till now i still cant believe it lol idk where it came from but srsly you're the lady luck	untill now i still cant believe it laughing out loud I do not know where it came from but seriously you're the lady luck
NGL	Not going to lie
so qt wtf	so cutie what the fuck
When I say I can't drink it's Bc I'm on antibiotics ppl	When I say I can't drink it's Because I'm on antibiotics people
Her dress Wazznt beautiful BSF she is pretty as hell	Her dress was not beautiful but seriously folks she is pretty as hell
oh my lorde wyd	oh my lorde what are you doing?
U r just an addict , ur r a junkie	you are just an addict , you are a junkie
TMTH	Too much to handle
i love u more bby mwah xoxo	i love you more baby kiss Kisses and Hugs
was thinking about that movie a sec before i saw ur tweet	was thinking about that movie a second before i saw your tweet
b4	before
I came f2f with her in the cafeteria	I came face to face with her in the cafeteria
always liking my tweets idk why u do it but I appreciate you mwah	always liking my tweets I do not know why you do it but I appreciate you kiss
YARLY	Yes, really
tatts	tattoo
sup baby gal — watching a movie w my family wbu	What's up baby girl — watching a movie with my family what about you
SICNR	Sorry, I could not resist
going out w ya girls more then BOOM fuck nigga got you pregnant	going out with your girls then BOOM fuck black man (offensive) got you pregnant
Wazznt	was not
BBFN	Bye Bye For Now
Meh , he's a lil over the top with international cultures	okay (not satisfied) , he's a lilttle over the top with international cultures
bday	birthday
RIP bird I shot	Rest in peace bird I shot
I want to go to that show! Wycm if you are going 2?	I want to go to that show! Will you call me if you are going too?
U mAk my hart melt	You make my heart melt
PD	Police department
Wtf are u saying man	What the fuck are you saying man
I know you will not listen to me so all I can do now is to wish you mtfbwy	I know you will not listen to me so all I can do now is to wish you may the force be with you (Good luck)
Just don't give up trying 2 do wat u really want 2 do	Just don't give up trying to do what you really want to do
SICS	Sitting In Chair Snickering
nfs im dead af off this 	no funny shit im dead as fuck off this 
Sounds like you're in a bit of a rut	Sounds like you're in a bit of a uncomfortable situation (or place)
CMIIW but you went there yesterday	Correct Me If I am Wrong but you went there yesterday
I g2g	I got to go
Pls DM me ur number	Please send direct message (on twitter) me your number
SUL guys	see you later guys
u prolly had no idea how far u would be now	you probably had no idea how far you would be now
FAQ	Frequently asked Questions
PDQ	Very quick
BION I am a fortune teller	Believe it or not I am a fortune teller
EG	Evil Grin
F2F	Face To Face
OIC	Oh, I see
the acronym CSG is Used to express a light hearted laugh	the acronym Chuckle, Snicker, Grin is Used to express a light hearted laugh
He's POTUS speaking to a hostile head of govt	He's President of the United States speaking to a hostile head of government
d	the
TYT	Take your time
NHOH	Never Heard Of Her
school, work, family, friendship AND relationship… that's TMTH	school, work, family, friendship AND relationship… that's too much to handle
mayb	maybe
tha big game is tomorrow so Be There Or Be Dead	the big game is tomorrow so Be There Or Be Dead
so u saying that idk whats been happening w/ my own life?	so you saying that i dont know whats been happening with my own life?
TYS	Told you so
WAM	Wait a minute
sep	especially
HART	heart
KIBO	Knowledge In, Bullsh*Out
u gotta vent abt it somewhere	you gotta vent about it somewhere
i only rted a vid w/o sound	i only retweeted (Twitter slang) a video without sound
ya I'm thriving wbu	yeah (yes) I'm thriving what about you
YKW	You know what
beautiful , in the best lane ofc , lysm and we should talk more xx	beautiful , in the best lane of course , love you so much and we should talk more Kisses
OTFL	On the floor laughing
SUITM	See you in the morning
BYKT don't trick me	But You Knew That don't trick me
ANFAWFOS	And Now For A Word From Our Sponsor
PLMK	Please let me know
yw very much	Your welcome very much
Meet him F2F for once	Meet him Face to Face for once
C&G	Chuckle and Grin
TRDMC	Tears Running Down My Cheeks
MOTOS	Member Of The Opposite Sex
WYCM	Will you call me
i shall be waiting 4u in the club	i shall be waiting for you in the club
tbh i dont rly like him	to be honest i dont really like him
the new version is now going under QC	the new version is now going under Quality control
thats super important, pls let me kno asaygt	thats super important, please let me know as soon as you get this
Sup Wakanda , it's me ya boi	what's up Wakanda , it's me your boy
LOLV	Lots Of Love
not the sharpest pencil in the box IYSWIM	not the sharpest pencil in the box If You See What I Mean
ily	I love you
say it louder for the ppl in the back sis	say it louder for the people in the back sister
P2P	Parent to parent
i'm sat here stalking my cousin's twitter tl bc it's always bombing w true shit	i'm sitting here stalking my cousin's twitter timeline because it's always bombing with true shit
OT	Off topic
Cardi B said... ”Fuck'em then I get some money”	Cardi be said... ”Fuck them then I get some money”
IIRC	If I Remember Correctly
if i can get u nd ur team mate autograh	if i can get you and your team mate autograh
That cheap camera I bought is broken already, I guss that's teach me WYGISWYPF	That cheap camera I bought is broken already, I guss that's teach me What You Get Is What You Pay For
Yw and ty very much ur sweet	Your welcome and thank you very much you are sweet
RBAY	Right back at you
yrs	years
sotmg, ttl	short of time,must go talk to you later
yall	you all
ur annoyed w my politics now??? just w8 til ima b on tv!!!!	you are annoyed with my politics now??? just wait until I will be on tv!!!!
PLOKTA	Press Lots Of Keys To Abort
NIMBY	Not in my back yard
Woke up hungry asl	Woke up hungry as hell
URTM	You are the man
when she ask "do I look fat?" and yttl to answer that's a problem	when she ask "do I look fat?" and you take too long to answer that's a problem
MRT	Modified ReTweet (Twitter slang)
sup bro	what's up brother
NTHING	Nothing
yk I will do a marathon of your fics later :)	you know I will do a marathon of your fictures later :)
pls CMIIW	please Correct Me If I am Wrong
ppl like You give rly good pointers / feedback for writing imo	people like You give really good pointers / feedback for writing in my opinion
lyk u mak mE	like you make me
I wiLL luv U 4ever	I will love you forever
TSH	Tripping so hard
WRUD	What are you doing
hey there, rys?	hey there, Are you single??
VFF	Very freaking funny
OB	Oh brother
‘cause	because
MLM	the middle finger
PYT	Pretty young thing
lmk if u want me or not , I'm not tryna waste my time	let me know if you want me or not , I'm not tring to waste my time
cant wait 2 move 2 a bigger room so i got more space 4 allllll my posters HAHAHA	cant wait to move to a bigger room so i got more space for all my posters laughing
IJWTS	I Just Want To Say
FYI	For Your Information
absolutely nthing bc i'm a lover not a fighter xoxo	absolutely nothing because i'm a lover not a fighter kisses and hugs
YCLIU	You can look it up
CYA next week BFN	see you next week bye for now
MOTD	Message of the day
SH^ or cry	Shut up or cry
lmk if u ever wanna chat or something!! it can be fun w/o pressure	let me know if you ever wanna chat or something!! it can be fun without pressure
Ngl nvr thought of it , still tryna tackle why	Not going to lie never thought of it , still trying to tackle why
I hate that, they always ask you wuf and such stuff	I hate that, they always ask you Where are you from? and such stuff
Omg can u imagine meet ur fave and introduce ur kid to them	Oh my god can you imagine meet your favorite and introduce your kid to them
MSG	Message
bbiab do not go anywhere	be back in a bit do not go anywhere
arggg	express anger
WBU	What about you
goin	going
MYOB	Mind your own business
I don't miss him IRL bc he is here with me , but I miss him being on twitter lol	I don't miss him in real life because he is here with me , but I miss him being on twitter Laughing Out Loud
Something that has to do w ur job mayb? I rly don't kno	Something that has to do with your job maybe? I really don't know
LLS	Laughing like silly
hey becky can we meet f2f?	hey becky can we meet face to face?
pmf but rachel is such a whore	Pardon my french but rachel is such a whore
if you or anyone you know can take on this task lmk ASAP	if you or anyone you know can take on this task Let me know As Soon As Possible
PMF	Pure Freaking Magic
My gf x follow me	My girlfriend former boyfriend (or girlfriend) follow me
idk why I thought it would be in English	I do not know why I thought it would be in English
ykw thats fine lyk i respect tht even with ur enthusiast for bby boi you still get the TRUTH	you know what thats fine like i respect that even with you are enthusiast for baby boy you still get the TRUTH
I'm not a fanboy of a fucking faggot who has no irl friends	I'm not a fanboy of a fucking gay man who has no in real life friends
RX	drugs or prescriptions
YG	young gangster
LMNK	Leave my name out
CID	Crying In Disgrace
omg I saw ur new gf	oh my god I saw your new girlfriend
kno	know
afaik it's true	as far as I know it is true
G2G	Got to Go
i'm a bit noob when it comes to game related terms	i'm a bit Not skilled person when it comes to game related terms
TPTB	The powers that be
see you tomorrow BFN	see you tomorrow bye for now
hsik what she thinks about it? Arg	How should I know what she thinks about it? express anger
OMG My mom is calling me for dinner so be seeing you	Oh my God my mom is calling me for dinner so be seeing you
happy bday!! good luck today , see you l8r ily	happy birthday!! good luck today , see you later I love you
ITSFWI	If The Shoe Fits Wear It
annie uok	annie are you okay
Her dress was not beau BSF she is pretty ASL	Her dress was not beautiful but seriously folks she is pretty as hell
CYA next week TTFN	see you next week bye bye for now
HAPPY BDAY KHIMDRICK ITS RLY UR BDAY THIS TIME LMAO	HAPPY Birthday KHIMDRICK ITS Really your Birthday THIS TIME laughing out loud
I love the holidays! Hhtyay mwah	I love the holidays! Happy Holidays to You and Yours kiss
I quite like them tbh	I quite like them to be honest
OMFG	Oh my fucking God
SK8RBOI	Skater Boy
shut the fuck up or QQ	Shut the fuck up or cry
Shut up or QQ	Shut up or cry
ORLY	Oh really?
amazin	amazing
PNCAH	Please, No Cursing Allowed Here
UNPC	Not politically correct
PMSL	Pee myself laughing
TOJ	Tears of joy
tom's friend? NHOH	tom's friend? Never Heard Of Him
I don't understand what's the BFD here	I do not understand what's the Big Frickin Deal here
LSV	Language, sex and violence
Yeah idk , I used to read my horoscope every day and then I grew up I guess lulz	Yeah I do not know , I used to read my horoscope every day and then I grew up I guess Laugh out loud
BYOB to my party	Bring Your Own Bottle to my party
jk imma fight ur ugly ass	just kidding I am going to fight your ugly ass
RUT	uncomfortable situation (or place)
BFN	Bye For Now
well u know what they say, Bend Over, Here It Comes Again	well you know what they say, Bend Over, Here It Comes Again
ppl treat u how they feel abt u	people treat you how they feel about you
I saw him this morning, he is BBR	I saw him this morning, he is Broken Beyond Repair
Despite 97 % of the media and so called Republicans hate POTUS, he keeps going Full Steam Ahead	Despite 97 % of the media and so called Republicans hate President of the United States, he keeps going Full Steam Ahead
I bet the govt had a great solution too	I bet the government had a great solution too
OMG My mom is calling me for dinner so be seeing you L8R	Oh my God my mom is calling me for dinner so be seeing you later
slay ur exams lyk a boss	slay your exams like a boss
TCOY	Take care of yourself
I betcha this movie is a good 1	I bet you this movie is a good one
Get yo ass to me pls pls pls	Get your ass to me please please please
SPK	Speak
WTTM	Without Thinking Too Much
R	Are
well you know what they say, BOHICA	well you know what they say, Bend Over, Here It Comes Again
CPP	C++ programing language
KYFC	Keep Your Fingers Crossed
URSKTM	You are so kind to me
WTFO	What the fuck? Over
WDYMBT	What Do You Mean By That
u are the only one who can cheer me up like that, LYSM	u are the only one who can cheer me up like that, Love you so much
it is less stressful cause u dont have to worry bout others	it is less stressful because you dont have to worry about others
Idk if u did me at all or not tbh	I do not know if you did me at all or not to be honest
RLCO	Real Life Conference
HHIS	Hanging Head In Shame
ngl when i like spam y'all , i'm not reading any of ur tweets	not going to lie when i like spam you all , i'm not reading any of your tweets
WYGAM	When you get a minute
TIAD	Tomorrow is another day
srsly? Now? Bc ima already late	seriously? Now? Because I am already late
bitch we have jobs. wbu???	bitch we have jobs. What about you???
ykw I mean…	you know what I mean…
WTN	What then now
SQ	Square
WITP	What is the point
BBR	Broken Beyond Repair
I'm doing a rly cool (pointless) 3 hours shift bc of ykw	I'm doing a really cool (pointless) 3 hours shift because of you know who
MAK	make
CUL	See you later
I have my team bak on a sat nite	I have my team back on a saturday night
2u	to you
Agreed wrt current education infrastructure and methodology	Agreed with regard to current education infrastructure and methodology
Fuck bo3 .. lol we out sry gg	fuck best of three (online gaming) .. Laughing out loud we out sorry good game
LYLAS. You are an amazing friend to have	love you like a sister. You are an amazing friend to have
This brand of soup is more expensive, but remember, WYGISWYPF	This brand of soup is more expensive, but remember, What You Get Is What You Pay For
My Lyf iz perfect	My life is perfect
u're	you are
these days are too busy for me so I can not handle that right now, I will TTYAWFN	these days are too busy for me so I can not handle that right now, I will Talk to you a while from now
this movie was shitty cuz it trash asl!	this movie was shitty because it trash as hell!
boiz are all atsl - only one thing on their minds	boys are all along the same line - only one thing on their minds
Lmao exactly like idk this might sound weird asl	Laughing out loud exactly like I don't know this might sound weird as hell
SYL	See you later
POS	Piece of Shit
ya i agree with u omg	yeah i agree with you oh my god
haha	laughing
fb	facebook
wish she would stfu lol	wish she would Shut the fuck up laughing out loud
U	you
OST	On Second Thoughts
RSVP by DM or email us	reply if you please by send direct message (on twitter) or email us
govt	government
issa	it is a
amazin'	amazing
NINO	Nothing In, Nothing Out
you are the best thing ever happened to me LYLC	you are the best thing ever happened to me Love you like crazy
pls don’t make such a Big Frickin Deal out of it	please don’t make such a Big Frickin Deal out of it
UN4TUN8	Unfortunate
PSP	Playstation Portable
sk8ng is fun	skating is fun
it is a fact that this corporation has a few women in top mgmt	it is a fact that this corporation has a few women in top management
UGTBK	You've got to be kidding
WUT	what
SHID	Slapping head in disgust
NFM	Not for me
MNC	Mother nature calls
baby you are the only one LUWAMH	baby you are the only one Love You With All My Heart
Thx lol you can dm me first	Thanks laughing out loud you can send direct message (on twitter) me first
OLL	Online love
TINWIS	That Is Not What I Said
When you tryna b cool and say sup bro	When you trying to be cool and say what's up brother
cb	call back
sat	saturday
happy bday my forever i love you since day 1 , no more long msg cause u know da rest!	happy birthday my forever i love you since day one , no more long message because you know the rest!
I need ya Weed mans number asap	I need your Weed mans number as soon as possible
GD&WVF	Grinning, Ducking, and Walking Very Fast
WUW	What do you want
Pls don't say that. RU serious?	Please don't say that. Are you serious?
rn	right now
how much imma spend on food today lmmfao	how much I am going to spend on food today Laughing out loud
URH	You are hot
I ttly fell down the stairs right in front of my crush. It wuz 2M2H	I totally fell down the stairs right in front of my crush. It was too much to handle
YEAH but ur rly qt	YEAH but you are really cutie
MUSM	Miss you so much
NTS	Note to self
RSN	Real soon now
MEH	okay (not satisfied)
If ya not my best friend to this levels then u don't deserve me pita vile	If you not my best friend to this levels then you don't deserve me pain in the ass vile
Lol that's bs wyd lil bro	Laughing out loud that's bullshit what are you doing lilttle brother
TNTL	Trying Not To Laugh
IYSS	If You Say So
RUOK	Are you okay
YWSYLS	You win some, you lose some
JWK	Just Wondering
Can some1 pls be my frnd and make plans w me in the summer thx	Can someone please be my friend and make plans with me in the summer thanks
SNAFU	Situation normal all fouled up
NM	Nothing much
FCFS	First Come, First Served
omg havent seen her pictures in so long OTL i rly like her	oh my god havent seen her pictures in so long express desperation i really like her
he was so sweet and when he walked me home I was lyk "wycm?"	he was so sweet and when he walked me home I was like "will you call me?"
ok girl, TTUL	ok girl, talk to you later
LSHMBA	Laughing So Hard My Belly Aches
RIP	Rest in peace
don't hmu if u aren't trying to fall in luv w me k thx	don't hit me up (text me or call me) if you aren't trying to fall in love with me okay thanks
N2M	Nothing too much
Oh my God my mom is calling me for dinner so BCNU L8R	Oh my God my mom is calling me for dinner so be seeing you later
TMWFI	Take my word for it
dnt	do not
k but ngl , i'm so conflicted abt that	okay but not going to lie , i'm so conflicted about that
OYO	On your own
LSHMBH this is the best chapter ever	Laughing So Hard My Belly Hurts this is the best chapter ever
Im a total noob and need people on my level haha	Im a total Not skilled person and need people on my level Laughing
TMA	Take my advice
lotta	a lot of
RYO	Roll your own
ex	former husband (or wife)
I miss my man , pls cb asap	I miss my man , please call back as soon as possible
x	ex
nvm sis	never mind sister
I don't know y he cruises the park. That place is AYOR	I don't know why he cruises the park. That place is at your own risk
IF I NVR WENT BAK 2 JAIL I CUD OV BIN DEAD	IF I NEVER WENT Back to JAIL I could have Been DEAD
gay asl	gay as hell
Lqtm well idk just lmk	Laughing quietly to myself well I do not know just let me know
CMIIW but r you goin out tonight	Correct Me If I am Wrong but are you going out tonight 
BYKT	But You Knew That
WEP	Weapon
SMHID	Scratching my head in disbelief
NBD	No big deal
PABG	Packing a Big Gun
WTF I JUST FOUND THIS TODAY	What The Fuck I JUST FOUND THIS TODAY
What's your favorite PROGGY?	What's your favorite computer program?
meh I come this far , I'll push it till four a.m	okay (not satisfied) I come this far , I'll push it untill four a.m
rlly	really
cul8r guys	see you later guys
Correct Me If I am Wrong but r u goin out tn	Correct Me If I am Wrong but are you going out tonight 
NFW	Not for work
SK8R	Skater
MTFBWY	May The Force Be With You (Good luck)
come here b4 ima falling asleep	come here before I am falling asleep
WYWH	Wish you were here
I h8 it when in the most suspenseful moment they said ANFAWFOS arggg	I hate it when in the most suspenseful moment they said And Now For A Word From Our Sponsor express anger
PMP	Peeing My Pants
let me get ready 4 work	let me get ready for work
M$	Microsoft
omg u sound like my lil sis	oh my god you sound like my lilttle sister
Ya, what wuz tht? tryin to hurt him?	Yeah (yes), what waz that? trying to hurt him?
WITW	What in the world
ryt	right
lyk u make mE	like you make me
AFAIK	As Far As I Know
HHTYAY	Happy Holidays to You and Yours
PZA	Pizza
T4BU	Thanks for being you
ok honey ttg ima ttyl	ok honey time to go I will talk to you later
WTM	Who's the man
I need to go on a date w/ her asap	I need to go on a date with her as soon as possible
WIIFM	What's in it for me?
I'm heated nfs	I'm heated no funny shit
LY	Love You
ROFLAS	Rolling On Floor Laughing And Screaming
TOU	Thinking of you
FUBAR	Fouled Up Beyond All Repair
I wiLL luv U 4 ever m8	I will love you forever mate
GOOD LUCK BRAVE GRL WATCH YA BACK AND DONT DISAPPEAR	GOOD LUCK BRAVE GIRL WATCH Your BACK AND DONT DISAPPEAR
Tn was fun asl	Tonight was fun as hell
y u think he will win d 2018 elections?	why you think he will win the 2018 elections?
SAPFU	Surpassing All Previous Foul Ups
LTOD	Laptop of death
my legs are pale af but my thighs are a lil brown. Wtf is up with that	my legs are pale af but my thighs are a lilttle brown. What the fuck is up with that
Wat r u ppl discussing?? U r nt frnds	What are you people discussing? you are not friends
thx couldnt have done it w/o ur deep speech	thanks couldnt have done it with out your deep speech
LYLAS	Love You Like A Sister
2b or not 2b, that's the question	to be or not to be, that's the question
yw ofc ur so cute	your welcome of course you are so cute
lmk pls i need ur help	let me know please I need your help
RYB	Read your Bible
Nvm fool lol nvm	Never mind fool Laughing Out Loud never mind
Hey, lets go sk8ng	Hey, lets go skating
Frnds, this (mostly) XLNT day. Wkd&wk are done	Friends, this (mostly) excellent day. Weekend&week are done
What discounts ru offering ppl who are against weapons of war?	What discounts are you offering people who are against weapons of war?
ok ppl r getting online kinda so i'll wait till later to finish	ok people are getting online kind off so i'll wait untill later to finish
OTOH	On the other hand
argg hsik what is wrong, what is right	express anger How Should I Know what is wrong, what is right
it's fragile so handle w care pls	it's fragile so handle with care pealse
QFI	Quoted for idiocy
I asked her how are you and she said NINO	I asked her how are you and she said Nothing In, Nothing Out
needs to puks from school	needs to Pick up kids from school
afaic, the issue is over and done with	As far as I am concerned, the issue is over and done with
Me LTM as I was introducing myself	Me Laughing to myself as I was introducing myself
I CRS anymore	I Can not Remember Shit anymore
LYLAB. You are an amazing friend to have	love you like a brother. You are an amazing friend to have
RU	Are you
STFU or cry	Shut the fuck up or cry
like y do u h8 us sis	like why do you hate us sister
ok girl, TTYS	ok girl, talk to you soon
SETE	Smiling Ear-to-Ear
mvp	Most Valuable Player
IWALU	I Will Always Love You
cuz im the real genius mvp lol	because im the real genius most valuable player laughing out loud
G1	Good One
happy bday! have to see u ASAP xxx	happy birthday! have to see you as soon as possible kisses
imo their songs r cheap	in my opinion their songs are cheap
wait y would VEG be in that equation lmfao	wait why would vegetarian be in that equation laughing out loud
TAM	Tomorro AM
AWC	After While, Crocodile
SRSLY	Seriously
CULA, after a while crocodile 	See you later alligator, after a while crocodile 
PZ	Peace
TTBOMK	To The Best Of My Knowledge
PTFO	Pass the fuck out
WIBAMU	Well, I will Be A Monkey's Uncle
I will do everything 4ur happiness	I will do everything for your happiness
I g2g CWYL	I got to go Chat with you later
TFS	Three Finger Salute (Ctl-Alt-Del)
TFTT	Thanks For The Thought
N1	Nice one
Lol why my ex texting me at 1am	Laughing out loud why my former boyfriend (or girlfriend) texting me at 1am
OI	Operator indisposed
xme, I nvr said that	Excuse Me, I never said that
Anthony sux lol haha what a bitch bro	Anthony sucks laughing out loud laughing what a bitch brother
It made me rlly happy so i had to lyk	It made me really happy so i had to like
NFS	Not for sale
PTL	Praise the Lord
TYSO	Thank you so much
my horrible ex give me a rtbs right now	my horrible former boyfriend (or girlfriend) give me a Reason to be single right now
Im good ty for asking and ty for ur wish	Im good thank you for asking and thank you for your wish
thought u seemed rlly cute n sweet but then i got rlly annoyed	thought you seemed really cute and sweet but then i got really annoyed
CU	See You
got to go BFN	got to go Bye for now
jk rly thinks its cute to saying he'd call his gf honey	just kidding really thinks its cute to saying he'd call his girlfriend honey
AFK	Away From the Keyboard
what is your favorite PROGGY?	what is your favorite computer program?
WASH UR FACE EVERY MORNING AND EVERY NIGHT AND WATCH UR SKIN GLOW YW	WASH your FACE EVERY MORNING AND EVERY NIGHT AND WATCH your SKIN GLOW Your Welcome
g2g BBFN	got to go Bye Bye for now
I hate that, they always ask you wayf and such stuff	I hate that, they always ask you Where are you from? and such stuff
pls teach me how to be u asap!!!	please teach me how to be you as soon as possible!!!
I asked her how are you and she said N2M	I asked her how are you and she said Nothing too much
oh k cya soon	oh okay see you soon
g2g B4N	got to go Bye for now
WCA	Who cares anyway
CMIIW but r you goin out tn	Correct Me If I am Wrong but are you going out tonight 
SSDD	Same stuff, different day
Lolwtf I went outside w no jewelry tf	Laughing out loud and saying What the fuck I went outside with no jewelry the fuck
stfu abt ur terrorist bf	shut the fuck up about your terrorist boyfriend
URA*	You are a star
big fan following u from ur 1st film as d film passes u r giving ur best	big fan following you from your 1st film as the film passes you are giving your best
ETLA	Extended Three Letter Acronym
plz look @ it	Please look at it
U know all u have 2 do is msg me and b like carter	you know all you have to do is message me and be like carter
WTF	What the fuck
I know I was a bully bc every time ppl talk about how horrible middle school was for them I'm like "meh I had a good time"	I know I was a bully because every time people talk about how horrible middle school was for them I'm like "okay (not satisfied) I had a good time"
hi I CU2! That vid is cool	hi I see you too! That video is cool
I g2g Chat with you later	I got to go Chat with you later
yw! have Storm pic to brighten ur morning	your welcome! have Storm picture to brighten your morning
see you tomorrow TTFN	see you tomorrow bye bye for now
I live in Montreal, QC	I live in Montreal, province of Quebec
fml I accidentally txt to my mom instead of my bff… st&d	fuck my life I accidentally text to my mom instead of my Best Friends Forever… Stop texting and drive
justin bieber ytg ily	justin bieber you're the greatest I love you
bif grandma called looking for you	before I forget grandma called looking for you
MOF account of the political rally	matter of fact account of the political rally
when u dream bout a date n in ur dream it awkward as hell lmao	when you dream about a date and in your dream it awkward as hell laughing out loud
and then he just said "TTUL gal" with a wink!	and then he just said "talk to you later girl" with a wink!
Ppl ask me what do u do? n i feel rlly wierd in tht moment!	People ask me whst do you do? and i feel really wierd in that moment!
U ppl whats wrong w/ u	you people whats wrong with you
MKAY	Mmm, okay
SBIA	Standing back in amazement
hav	have
my tl completely changed , tf happened?	my Timeline (twitter) completely changed , the fuck happened?
MWAH	Kiss
I prolly say that every day lmao	I probably say that every day laughing out loud
playing an AWC game	playing an awesome game
please CMIIW	please Correct Me If I am Wrong
haha oh I forgot bout that lulz	laughing oh I forgot about that Laugh out loud
Idk I think ima call some shops or something cuz I don't want to w8 till march 9th	I dont know I will call some shops or something because I don't want to wait untill march 9th
GOWI	Get On With It
OMG I Can not Remember Shit	Oh my God I Can not Remember Shit
IMPOV, u should not be dating	In My Point Of View, you should not be dating
hhh	laughing
WWNC	Will wonders never cease
im gonna rsvp ur name for this wedding and reception	im gonna reply if you please your name for this wedding and reception
ok jk here's the realistic version	ok just kidding here's the realistic version
DIY	Do It Yourself
my friend had the worst dream last night that his Mom caught him masturbating tff	my friend had the worst dream last night that his Mom caught him masturbating too fucking funny
HMU asap	Hit me up as soon as possible
QOTD	Quote of the day
SMH	shaking my head
STW	Search the Web
SorG	Straight or Gay?
how am i? well, nmjc	how am i? well, Nothing much, just chilling
LVM	Left voice mail
xme for my french	Excuse Me for my french
VFM	Value for money
Jack is posting the concert to sc	Jack is posting the concert to snapchat
IYSWIM	If You See What I Mean
IAE	In Any Event
i bought the vans x spongebob sk8 highs and now im happy	i bought the vans x spongebob skater highs and now im happy
WOTAM	Waste Of Time And Money
GTG	Got To Go
O4U	Only for you
thm	them
and i'll 4ever be a vip and their lil yg trash	and i'll forever be a Very important person and their lilttle young gengster trash
IMAO	In My Arrogant Opinion
Happy bday! Thx for this pic at the game	Happy birthday! Thanks for this picture at the game
meh , I'm bored	okay (not satisfied) , I'm bored
ask her out already ut2l man	ask her out already You take too long man
hello Raksh my best wishes 2 u for what u been doing nd for d upcoming work	hello Raksh my best wishes to you for what you been doing and for the upcoming work
Correct Me If I am Wrong but r u going out 2nite	Correct Me If I am Wrong but are you going out tonight 
when imma see you	when I Am Going To see you
Mkay well I'm almost 2 hours away with traffic and I don't drive	Mmm , okay well I'm almost 2 hours away with traffic and I don't drive
I wiLL luv U 4ever m8	I will love you forever mate
OTL	express desperation
MOTSS	Member Of The Same Sex
GFR	Grim File Reaper
WOMBAT	Waste of money, brains and time
PEEPS	People
omg. so sorry to hear , rip	Oh my god. so sorry to hear , rest in peace
af	as fuck
yw, check ur fb	your welcome, check your facebook
ROFL	Rolling on floor laughing
yk	you know
WAYF	Where are you from?
Too much madness in my house im omw to ur house	Too much madness in my house im on my way to your house
pmf, but this tasted like shit	Pardon my French, but this tasted like shit
XLR8	Excelerate
SB	Smiling back
TA	Thanks a lot
NW	No way
LYSM	Love you so much
k luv u, CU2	okay love you, see you too
WTGP	Want to go private (talk out of public chat area)
WEBO	Webopedia
I want yall to have a glimpse into the random bs that comes into my life	I want you all to have a glimpse into the random bullshit that comes into my life
beyonce you are the best! Luwamh	beyonce you are the best! Love You With All My Heart
TAFN	That's all for now
BOT	Back On Topic
oomf	one of my followers
Bro get at me ASAP!!! Im a PG	brother get at me as soon as possible!!! Im a PG
tha big game iz tomorrow so Be There Or Be Dead	the big game is tomorrow so Be There Or Be Dead
Rest in peace lil man	Rest in peace little man
I g2g so I will Chat With You Later	I got to go so I will Chat with you later
RRQ	Return Receipt Request
CYA next week BBFN	see you next week bye bye for now
i can't w8 to meet u	i can't wait to meet you
Lmao y'all really mad idk how to play spades	Laughing Out Loud you all really mad I do not know how to play spades
ctfu	laughing hard
Oh wow can I die pls omg	Oh wow can I die please oh my god
tbh I only love ur sis while shes still a cutie	to be honest I only love your sister while shes still a cutie
Have u been watching at all? IMO , miracle is the reason they are bak together	Have you been watching at all? In My Opinion , miracle is the reason they are back together
NFW	No fucking way
ez	easy
IME	In My Experience
I put u on to good shows bro	I put you on to good shows brother
Send me ur sc usernames	Send me your snapchat usernames
Believe it or not I luv it	Believe it or not I love it
Y	Why
Tq dear ily n miss u alottt	I love you (in Spanish) dear i love you and miss you alottt
rlly dont get ppl who are "bothered" by their own actions but dont make an effort to change sooooo wyd then	really dont get people who are "bothered" by their own actions but dont make an effort to change sooooo what are you doing then
u can pic w me whenever u want and its ok i lyk making frnds!!!	you can picture with me whenever you want and its ok i like making friends!!!
LUV	love
Idk bout you guys but , my family is the ppl that struggle w me	I do not know about you guys but , my family is the people that struggle with me
Mayb I'll bless the TL w/ a pic once I get it lol I just ordered it	Maybe I'll bless the timelime (twitter) with a picture once I get it laughing out loud I just ordered it
YGTI	You Get The Idea
everyone asks me y dont u get married? Myo	everyone asks me y dont u get married? Mind your own business
my mom bought me playstation! Mom ytb!	my mom bought me playstation! Mom You're the best!
got to go TTFN	got to go Bye Bye for now
Idk where i put my starbucks bottle my bf bought for me	I do not know where i put my starbucks bottle my boyfriend bought for me
y did u leave college?	why did you leave college?
mkay i'll be bak l8r I have tons of work to do lol	Mmm , okay i'll be back later I have tons of work to do Laughing Out Loud
I asked her how are you and she said NMJC	I asked her how are you and she said Nothing much, just chilling
afaic the system should have handled that correctly	As Far As I am Concerned the system should have handled that correctly
please CMIIW and do not lie 2 me	please Correct Me If I am Wrong and do not lie to me
wup frenny, u're talkative and such. i'm lucky to be ur friend, take care x	what's up frenny, you're talkative and such. i'm lucky to be your friend, take care kiss
BYOB to tha party next month	Bring Your Own Bottle to the party next month
frnds	friends
rip hero… gone but never forgotten	rest in peace hero… gone but never forgotten
OB	Oh baby
why does it always rain on me? Tanj	why does it always rain on me? There is not Justice
I must visit my friends asap coz I really miss them	I must visit my friends as soon as possible because I really miss them
CU tomorrow TTFN	see you tomorrow bye bye for now
ima tryin 2 cal but cant get you	I am trying to cal but cant get you
BION I luv it	Believe it or not I love it
I'm a hard core sk8r. Lets go sk8	I'm a hard core skater. Lets go skate
tbh i cant rly wait for winner to cb this time	to be honest i cant really wait for winner to call back this time
lmk when you on the way k?	let me know when you on the way okay?
You are obv going to give me a dollar	You are obviously going to give me a dollar
LTM literally talked abt how he kinda knew he's too young	Laughing To Myself literally talked abt how he kinda knew he's too young
ive liked a lot of my all times fav ytb playlists	ive liked a lot of my all times favorite youtube playlists
do u just hate it when ur hands shake after u drink meds bc I do and ykw fck that I'm gonna study	do you just hate it when your hands shake after you drink meds because I do and you know what fuck that I'm gonna study
I am using CPP	I am using C++ program language
VN	Very nice
it always taking me so long to write back bc I am hoyew	it always taking me so long to write back because I am Hanging On Your Every Word
ima bout to clear that tl out if i unfollow dm me	I am about to clear that timeline (twitter) out if i unfollow send direct message (on twitter) me
TMOT	Trust me on this
omg he just tweeted!!!!!! brb	oh my god he just tweeted!!!!!! Be right back
BTHOM	Beats The Hell Out Of Me
PMFBI	Pardon Me For Interfering
Sry jk we are BFF Bro	Sorry just kidding we are Best Friends Forever Brother
The volunteers take three times as long with the mailing, but WYGISWYPF	The volunteers take three times as long with the mailing, but What You Get Is What You Pay For
livin	living
u r the best ly xx	you are the best love you Kisses
Stay away from the boss today, he's in a bad mood aattw	Stay away from the boss today, he's in a bad mood a word to the wise
I've only done half of it, I'm s2s	I've only done half of it, I'm sorry to say
btw if u don't hate me , follow me	by the way if you don't hate me , follow me
i think there is no scale tht can measure ur beauty	i think there is no scale that can measure your beauty
SUL	Snooze You Loose
NT	not
WTH	What the hell
ohhhh come on! AWGTHTGTTA	ohhhh come on! Are We Going To Have To Go Through This Again
YF	Wife
man ppl rly act like not caring abt spelling	man people really act like not caring about spelling
yrw bb i want some cute tops pls!!	you are welcome baby i want some cute tops please!!
Her dress Wazznt beautiful BSF she is pretty ASL	Her dress was not beautiful but seriously folks she is pretty as hell
arggg wup w/ da train	express anger what's up with the train
ABT	about
You lame asl!	You lame as hell!
tfw no gf with long qt syndrome	that feeling when no girlfriend with long cutie syndrome
cop	to get
ATSL	Along The Same Line
CYA	See You
WUCIWUG	What you see is what you get
TNXE6	Thanks A Million
see you tomorrow B4N	see you tomorrow bye for now
smokin	smoking
Y'all dumb asl	you are all dumb as hell
TFTF	Thanks for the follow (In Twitter)
ne1 I kno?	anyone I know?
why ru up at this hour and Dont say work cuz that will make me sad	why are you up at this hour and Dont say work because that will make me sad
WRU@	Where are you at
ur not a snack if everyone had a bite , u a free sample	you are not a snack if everyone had a bite , you a free sample
PLD	Played
Sry hhos we are BFF Bro	Sorry Ha Ha Only Serious we are Best Friends Forever Brother
ONNA	Oh No, Not Again
Oh gosh I forgot to msg u	Oh gad I forgot to message you
LTLWDLS	Let's twist like we did last summer
IBK	Idiot Behind Keyboard
PLU	People like us
TTFN	Bye Bye for now
PTO	Personal time off
MRA	Moving Right Along
UDS	Ugly domestic scene
why these shit keep happening to me? Tanj	why these shit keep happening to me? There is not Justice
SIS	Sister
WL	What a loser
HBASTD	Hitting Bottom And Starting To Dig
OMW	On my way
IT ONLY TOOK 2 DAYS BEAT THAT LOSERS LMAO hhoj LUV YOU GUYS	IT ONLY TOOK TWO DAYS BEAT THAT LOSERS Laughing out loud Ha Ha Only Joking LOVE YOU GUYS
u r da man	you are the man
PCMCIA	Personal Computer Memory Card
RYS	Read your screen
ive told you to not post any pic of me or any pic that i was in so pls respect tht	ive told you to not post any picture of me or any picture that i was in so please respect that
TAF	That is All Folks
O	Hugs
you have such a big heart! T4bu	you have such a big heart! Thanks for being you
YG	Young gentleman
UW	You're welcome
OOTC	Obligatory On-Topic Comment
BAC	Bad Assed Chick
Correct Me If I am Wrong but r u goin out 2nite	Correct Me If I am Wrong but are you going out tonight 
BC	Because
im lil bit scared but idk why am i like this	im little bit scared but I do not know why am i like this
these days are too busy for me so I can not handle that right now, I will TTYAFN	these days are too busy for me so I can not handle that right now, I will Talk to you a while from now
Lotta ppl on my TL been calling it the greatest movie ever lol	a lot of people on my timeline (twitter) been calling it the greatest movie ever laughing out loud
More cool shirts are otw Tell ya friends pls	More cool shirts are on the way Tell your friends please
thanks	Thank you
2nite	tonight
Believe it or not IMA fortune teller	Believe it or not I am a fortune teller
Wrt the other arguments	with regard to the other arguments
I need you, call me ASAYGT	I need you, call me As Soon As You Get This
LUWAMH	Love You With All My Heart
how much imma spend on food today hehehe	how much I am going to spend on food today Laughing
we're so sry about that! Please DM us w/ your contact info	we're so sorry about that! Please send direct message (on twitter) us with your contact info
TD2M	Talk dirty to me
I actually agree w ur ted talks pls don't take it srsly	I actually agree with your ted talks please don't take it seriously
YMMV	Your mileage may vary
OTW	on the way
omg boi wyd raise ur kid well pls	oh my god boy what are you doing raise your kid well please
W/E	Whatever
1	one
TCO	Total Cost of Ownership
LIL	little
AWS	Awesome
MTF	More to follow
Lls idek wat ima do for boo b day	Laughing like silly I do not know what I will do for his birthday
FYI my car xlr8 better	For Your Information my car excelerate better
LMFAO	Laughing out loud
IMNSHO their songs r cheap	In My Not So Humble Opinion their songs are cheap
youre a lil edgy and intimidating to me at times but ur a treasured mutual mwah mwah	youre a lilttle edgy and intimidating to me at times but you are a treasured mutual kiss kiss
u aint slick I hear u	you are not (acting) smooth I hear you
HNY	Happy New Year
BOHICA	Bend Over, Here It Comes Again
LTHTT	Laughing Too Hard To Type
THX	Thanks
idk what to tell you bout em lol smh	I do not know what to tell you about them Laughing out loud shaking my head
Stfu boi cuz yo profile pic is ugly	Shut the fuck up boy because your profile picture is ugly
irl I dont care abt presents	in real life I dont care about presents
tryna	trying to
SUL sis	See You All Later sister
Her dress Wazznt beautiful but seriously folks she is pretty ASL	Her dress was not beautiful but seriously folks she is pretty as hell
can u send me a sc of it if	can you send me a snapchat of it
when u forgot u are texting irl	when you forgot you are texting in real life
TSTB	The sooner, the better
absolutely h8 public transport bc ppl r so disgusting	absolutely hate public transport because people are so disgusting
got to go, TTUL	got to go, talk to you later
LABATYD	Life is A Bitch And Then You Die
rted	Retweeted (Twitter slang)
I am starving! Ate nthing today	I am starving! Ate nothing today
pls lmk who u r bc i still dont know	please let me know who you are because i still dont know
YCDBWYCID	You can't do business when your computer is down
SUL bro	See You All Later brother
noooo dm me if u need me mwah	no send direct message (on twitter) me if you need me kiss
i just want to cuddle up w/ a qt	i just want to cuddle up with a cutie
JIC	Just In Case
OM	Oh, my
why do ut2l to ask her to marry you?	why do you take too long to ask her to marry you?
it's one of my ex closest friend's bday and i just texted her , i miss her ngl	it's one of my former boyfriend (or girlfriend) closest friend's birthday and i just texted her , i miss her not going to lie
pls b real w us	please be real with us
good luck w applications its stressful ngl but u'll get there	good luck with applications its stressful not going to lie but you'll get there
IAW	In Accordance With
I love you so much that it BTHOM	I love you so much that it Beats The Hell Out Of Me
Rip lil man	Rest in peace little man
Oh you mean lil me? The baby me?	Oh you mean lilttle me? The baby me?
Omg I'm so curious who's the mc	Oh my god I'm so curious who's the rapper
IYFEG	Insert Your Favorite Ethnic Group
BBIAF	Be Back In A Few
OL	Old
when u find out the answer lmk sis	when you find out the answer let me know sister
OMG My mom is calling me for dinner so BCNU L8R	Oh my God my mom is calling me for dinner so be seeing you later
IBTD	I Beg To Differ
Lol ya u know	Laughing out loud yeah you know
plz play this song ty and Ily	please play this song thank you and I love you
Btw , love ur msg background	By the way , love your message background
NE14KFC	Anyone want to eat KFC
aisi only a naive person will buy it	as I see it only a naive person will buy it
TMTH	Too much to handle
I love watching Friends so much that I think I am actually MFI	I love watching Friends so much that I think I am actually Mad For It
PM	Private Message
SYL bro	See You All Later brother
I feel vry happy when u lyk my comments	I feel very happy when you like my comments
goodmorning bitch, wyd bitch, tf bitch lmmfao	goodmorning bitch, what are you doing bitch, the fuck bitch laughing out loud
nvm ppl gunna laugh at how much my acc sux	never mind people going to laugh at how much my account Sucks
ruok? I know you two where close	are you okay? I know you two where close
u r so cute do u wan2 snort a line w me and fuck on ur parents bed	you are so cute do you want to snort a line with me and fuck on your parents bed
SOAB	Son of a bitch
NWO	No way out
PRT	Please Retweet (Twitter)
Lol u rlly sure need ban these bots idk	Laughing Out Loud you really sure need ban these bots I do not know
Really going to be ptfo if I can't log into my icloud	Really going to be Pass the fuck out if I can't log into my icloud
LMK	Let me know
UNCRTN	Uncertain
PDA	Personal display of affection
NE14KFC? I can not say no to that	Anyone want to eat KFC? I can not say no to that
IMA using C++ program language	I am using C++ program language
U choose ur decision IMNSHO	you choose your decision In My Not So Humble Opinion
hhok ok here's the realistic version	Ha Ha Only Kidding ok here's the realistic version
CUL8R guys	see you later guys
actual footage of me leaving SC after I post a pic or vid on my story	actual footage of me leaving snapchat after I post a picture or video on my story
this was a big BWQ	this was a big Buzz Word Quotient
NE1	Anyone
what a qt	what a cutie
ISWYM	I See What You Mean
y'all	you all
VM	Voice mail
SAL	Such a laugh
GR&D	Grinning, Running and Ducking
lmk if u are coming so i can wait for u	let me know if you are coming so i can wait for you
if u find a liquid african black soap lmk bc it's my fav soap	if you find a liquid african black soap let me know because it's my favorite soap
Abt to be 22 and flat chested asl	about to be 22 and flat chested as hell
i love u but i gtg bc school	i love you but i got to go because school
ISSYGTI	I am So Sure that  You Get The Idea
2 good 2 b true	too good to be true
2	to
XOXOXO	Kisses and Hugs
ne1 would think its real	anyone would think its real
NMU	Not much, you?
ITFA	In The Final Analysis
the marathon has forced me to come f2f with my physical limitations	the marathon has forced me to come face to face with my physical limitations
NE14KFC	Anyone want to eat KFC
Idk her name lol	I do not know her name Laughing out loud
SPTO	Spoke to
ANFAWFOS is a great movie	And Now For A Word From Our Sponsor is a great movie
TY	Thank you
MYO	Mind your own business
CMIIW but r you goin out 2nite	Correct Me If I am Wrong but are you going out tonight 
Pft ofc he doesnt lol stupid me	An exlamation of disbelief of course he doesnt laughing out loud stupid me
QT	Cutie
pls pass the msg thx	please pass the message thanks
GAL	Get A Life
OTTOMH	Off the top of my head
lol this lil green cartoon is my fav	Laughing Out Loud this little green cartoon is my favorite
tryin	trying
AFAIR	As Far As I Remember
ROFLMAO	Rolling on the floor, laughing my ass off
OMG My mom is calling me for dinner so be seeing you later	Oh my God my mom is calling me for dinner so be seeing you later
WBS	Write back soon
CMIIW but r u going out tn	Correct Me If I am Wrong but are you going out tonight 
im super busy today, ttyt bby	im super busy today, talk to you tomorrow baby
VBS	Very big smile
NMJC	Nothing much, just chilling
Oh sis I didn’t wanna see that close LOLwtf	Oh sister I didn’t wanna see that close Laughing out loud and saying What the fuck
WB	Welcome back
I have a cleanest kitchen IYSWIM	I have a cleanest kitchen If You See What I Mean
you are on twitter although you trying to avoid spoilers?! Mtfbwy	you are on twitter although you trying to avoid spoilers?! may the force be with you (Good luck)
Idk I think u didn't but idk u probably did	I do not know I think you didn't but I do not know you probably did
INPO	In No Particular Order
FUBB	Fouled Up Beyond Belief
YCMU	You crack me up
you always assume I kno all those ppl but actually nhoh	you always assume I know all those people but actually never heard of her
OTT	Over the top
CMIIW	Correct Me If I am Wrong
CRS	Can not Remember Shit
i feel rlly wierd in tht moment	i feel really wierd in that moment
LMIRL	Lets meet in real life
ima b str8 , I'm not tryna go bak to my past	I will be straight , I'm not trying to go back to my past
2gethr	together
txt	text
MU	Miss you
Bro ngl I'm fed up	Brother not going to lie I'm fed up
RMMM	Read my mail man
FYI , she doesn't like talking to ppl so I can say I'm lucky bc she's actually replying	For your information , she doesn't like talking to people so I can say I'm lucky because she's actually replying
Omg, let me repeat Omfg !!!	Oh my god, let me repeat Oh my fucking God !!!
Correct Me If I am Wrong but r u going out tonight	Correct Me If I am Wrong but are you going out tonight 
WIU	Wrap it up
YTTL	You take too long
lol stfu	Laughing out loud Shut the fuck up
“you're mean bc you're an Aries” no , shutup. kma how abt that.	“you're mean because you're an Aries” no , shutup. Kiss my ass how about that.
I can't send you DM . But i rw your post	I can't send you send direct message (on twitter) . But i Retweet (Twitter slang) your post
you need to choose computer that fits 4ur needs	you need to choose computer that fits for your needs
srsly annoyed w/ a bts fan on my fan acc	seriously annoyed with a bts fan on my fan account
TMB	Tweet me back
TTYT	Talk To You Tomorrow
s/o	shout out
Lmho Don't Entertain Me Right Now, I'm Drunk Asl	Laughing my head off Don't Entertain Me Right Now, I'm Drunk As Hell
y omg LTHTT	Why oh my god Laughing Too Hard To Type
NLT	No later than
Idk what that means stfu	I do not know what that means shut the fuck up
PMJI	Pardon My Jumping In
bogus	silly
omg we gone be so fucked up omg enjoy these last days sis	oh my god we gone be so fucked up oh my god enjoy these last days sister
Cuz that person bet my record I replied my friend msg after 2 years	because that person bet my record I replied my friend message after 2 years
b day	birthday
I got to go so I will CWYL	I got to go so I will Chat with you later
dont be shy idk how to bite ppl lol	dont be shy I do not know how to bite people Laughing Out Loud
ur both mom and dad??? That's definitely TMTH	your both mom and dad??? That's definitely too much to handle
tq for ur continuos update	I love you (in spanish) for your continuos update
ST&D	Stop texting and drive
SUX	Sucks
u r so sw8 2 me	you are so sweet to me
ikr	I know, right
deactivated my fb acct bc y not?	deactivated my facebook account because why not?
NFM	None for me
2 me	to me
MOOS	Member of the opposite sex
You can use it, but it’s ayor	You can use it, but it’s at your own risk
GMTA	Great Minds Think Alike
btw imo i love staedler pencils	by the way in my opinion i love staedler pencils
b	be
I agree with what our POTUS just did	I agree with what our President of the United States just did
Fuck'em	fuck them
afair the system should have handled that correctly	As Far As I Remember the system should have handled that correctly
WC	Toilet
I need 2 go now, ttyawfn	I need to go now, Talk to you a while from now
PLZ	Please
TGIF	Thank God it's Friday
HOYEW	Hanging On Your Every Word
CMIIW but r you going out 2nite	Correct Me If I am Wrong but are you going out tonight 
pls no hhok lol but srsly no. hhos	please no Ha Ha Only kidding Laughing Out Loud but Seriously no. Ha Ha Only Serious
ANFSCD by Monty Python	And Now For Something Completely Different by Monty Python
some1 rly just unfollowed me after i rted my own damn commissions post	someone really just unfollowed me after i retweeted (Twitter slang) my own damn commissions post
this is a BWQ	this is a Buzz Word Quotient
y'all ugly asl	you are all ugly as hell
4 ever	forever
IMPOV	In My Point Of View
got to go, TLK2UL8R	got to go, talk to you later
I will do everything 4u	I will do everything for you
gunna	going to
Waiting 4 U @ home	Waiting for you at home
that's not cool man… SSINF	that's not cool man… So stupid it's not funny
SC	Snapchat
pls update us abt the audio function	please update us about the audio function
PMIGBOM	Put Mind In Gear, Before Opening Mouth
i love u lolo	i love you lots of love
meh i'll find my shit elsewhere lol	okay (not satisfied) i'll find my shit elsewhere Laughing Out Loud
since you ask- impov it makes you look cheap	since you ask- In My Point Of View it makes you look cheap
check dm ASAP	check direct message (on twitter) as soon as possible
mfs be tryna act cold hearted but be sweet asl	motherfucker be trying to act cold hearted but be sweet as hell
hahaha	laughing
AISI	As I See It
are'nt you at home? wru@	are'nt you at home? Where are you at
ANFSCD is a great movie	And Now For Something Completely Different is a great movie
ONL	Online
They won't kno me on this acct	They won't know me on this account
maybe she is sick? Stop judging and myob	maybe she is sick? Stop judging and Mind your own business
ctfu he was bogus asl	laughing hard he was silly as hell
Hey, AWHFY?!	Hey, Are We Having Fun Yet?!
YHL	You have lost
Correct Me If I am Wrong but r you going out 2nite	Correct Me If I am Wrong but are you going out tonight 
She Not Gone Have Time For Other Ppl	She Not Gone Have Time For Other People
QSL	Reply
NIH	Not Invented Here
TGAL	Think Globally, Act Locally
HTH	Hope That Helps
doin	doing
AWGTHTGTTA? plz dont tell me we do	Are We Going To Have To Go Through This Again? please dont tell me we do
SEC	second
and btw I have 1 best friend not 2	and by the way I have one best friend not two
ty qt	thank you cutie
YBIC	Your brother in Christ
pls no hhoj lol but srsly no. hhos	please no Ha Ha Only Joking Laughing Out Loud but Seriously no. Ha Ha Only Serious
YKYARW	You Know You are A Redneck When
You mAk my hart melt	You make my heart melt
you looks pale, uok	you looks pale, are you okay
C&G is Used to express a light hearted laugh	Chuckle and Grin is Used to express a light hearted laugh
fyi it shouldn't be abt it	For your information it shouldn't be about it
I remind U NVR 2 act ur age	I remind you never to act your age
Yrw and ty very much ur sweet	You are welcome and thank you very much you are sweet
DA	the
ok girl, ttyl	ok girl, talk to you later
Oh yes, POTUS is a miracle worker. No other president has ever demonstrated such heroic diplomatic	Oh yes, President of the United States is a miracle worker. No other president has ever demonstrated such heroic diplomatic
VEG	vegetarian
IDTS	I don't think so
yo	your
DILLIGAD	Do I Look Like I Give A Darnn
Her dress was not beau but seriously folks she is pretty ASL	Her dress was not beautiful but seriously folks she is pretty as hell
BYKT so don't trick me	But You Knew That so don't trick me
MGMT	Management
WYHAM	When you have a minute
bbiaf do not go anywhere	be back in a few do not go anywhere
NITL	Not In This Lifetime
THNQ	Thank you
WYD	What are you doing
lol I got a lil nigga right now who got caught	Laughing Out Loud got a lilttle black man (offensive) right now who got caught
ppl will stab u at ur back and ask u y r u bleeding	people will stab you at your back and ask you why are you bleeding
NTIM	Not That It Matters
yw bb i want some cute tops pls!!	your welcome baby i want some cute tops please!!
Lol u ryt	Laughing out loud you right
cya guys later	see you guys later
TNX	Thanks
LTM	Laughing To Myself
how do u think u are going to react for real if u see chris irl	how do you think you are going to react for real if you see chris in real life
GFN	Gone For Now
dm me and lmk	send direct message (on twitter) me and let me know
A pic of me trya make my bun into Kian :) yw	A picture of me trying to make my bun into Kian :) your welcome
lmfao i'm not against her but everyone knows that yg is a shitty PD you don't have to remind her	laughing out loud i'm not against her but everyone knows that young gangster is a shitty Police Department you don't have to remind her
LTNT	Long Time, No Type
SYL guys	see you later guys
LYK	like
FTASB	Faster Than A Speeding Bullet
Tnx buddy!!	Thanks buddy!!
Hmu via txt msg	Hit mw up via text message
LQTM	Laughing quietly to myself
nigga	black man (offensive)
Tbh think my face says it all abt meeting	To be honest think my face says it all about meeting
ASAP	As Soon As Possible
OMG I HAVENT BEEN ONLINE IDK WHO IS WHO ANYMORE BUT I WANNA SEE PICS PLS HAHA	OH MY GOD I HAVENT BEEN ONLINE I DO NOT KNOW WHO IS WHO ANYMORE BUT I WANNA SEE PICTURES PLEASE HAHA
BION IMA fortune teller	Believe it or not I am a fortune teller
ROTFLOLAPMP	Rolling On The Floor Laughing Out Loud And Peeing My Pants
IANAL	I Am Not A Lawyer
W@	What?
SFLA	Stupid Four Letter Acronym
NE	Any
SB	Should be
SUL	See you later
I just finished writing the best PROGGY	I just finished writing the best computer program
YABA	Yet another bloody acronym
TILIS	Tell it like it is
XME	Excuse Me
OVA	Over
ngl but lmao at ppl tweeting I'm expecting something	not going to lie but Laughing out loud at people tweeting I'm expecting something
got to go, TTYS	got to go, talk to you soon
TU	Thank you
TTKSF	Trying To Keep a Straight Face
SUFID	Screwing Up Face In Disgust
omg idk who you are	Oh my God I do not know who you are
this pic ugly asl	this picture is ugly as hell
I asked her how are you and she said NM	I asked her how are you and she said Nothing much
its NP for me	its no problem for me
Ya	you
ur both mom and dad??? That's definitely 2M2H	your both mom and dad??? That's definitely too much to handle
I came ftf with her in the cafeteria	I came face to face with her in the cafeteria
G	Grin
Lls nigga don't u have a bf	Laughing like silly nigga don't you have a boyfriend
sc me	snapchat me
tha big game is tomorrow so BTOBD	the big game is tomorrow so Be There Or Be Dead
I'm on the couch ptfo	I'm on the couch Pass the fuck out
I cant support ugly pics in my tl lol	I cant support ugly pictures in my Timeline (twitter) laughing out loud
IRL	In Real Life
SWMBO	She who must be obeyed (wife)
POV	Point of view
love you! But not in a romantic way, lylas	love you! But not in a romantic way, Love You Like A Sister
why do you insists on going there alone? mtfbwy	why do you insists on going there alone? May the force be with you (Good luck)
CUL8R sis	See You All Later sister
TYVM	Thank you very much
arg	express anger
Oh my God my mom is calling me for dinner so be seeing you L8R	Oh my God my mom is calling me for dinner so be seeing you later
SMH	so much hate
and then he just said "TTYS gal" with a wink!	and then he just said "talk to you soon girl" with a wink!
I prolly say that every day hehe	I probably say that every day laughing 
OOTO	Out of the office
u r hot	you are hot
MOTAS	Member Of The Appropriate Sex
QC	province of Quebec
MFI	Mad for it
XXX	Kisses
ykw i'll make a list just like fairy did bc i'm too lazy to mention n nvr make it on time	you know what i'll make a list just like fairy did because i'm too lazy to mention and never make it on time
GDW	Grin, Duck and Weave
Rip little man	Rest in peace little man
Lmk you tryna cop a 36 inch tv	Let me know you trying to get a 36 inch tv
hmu	hit me up (text me or call me)
LMHO	Laughing My Head Off
HAK	Hugs And Kisses
he said bbl and loged off	he said be back later and loged off
Guess imma listen to that album now. Again.	Guess I am going to listen to that album now. Again.
love you! But not in a romantic way, lylab	love you! But not in a romantic way, Love You Like A Brother
idk y y'all think he is sweet for it	I do not know why you all think he is sweet for it
DWIMC	Do What I Mean, Correctly
i HATE HATE HATE when ppl tell me to smile more stfu	i HATE HATE HATE when people tell me to smile more shut the fuck up
NTYMI	Now That You Mention It
I need 2 go now, ttyafn	I need to go now, Talk to you a while from now
NSISR	Not sure if spelled right
pls don't date someone / stay w someone who doesn't make u feel secure	please don't date someone / stay with someone who doesn't make you feel secure
vid	video
TFF	Too fucking funny
AWGTHTGTTA	Are We Going To Have To Go Through This Again
I'm not stepping with anyone this summer that makes face if ask em to take a pic of me , do 1 m8.	I'm not stepping with anyone this summer that makes face if ask them to take a picture of me , do one mate.
yrw! have Storm pic to brighten ur morning	you are welcome! have Storm picture to brighten your morning
NIFOC	Naked in front of computer
PMFI	Pardon me for interrupting
PPU	Pending pick-up
YGLT	You are Going to Love This
PMFJI	Pardon me for jumping in
Don't msg me on sc	Don't message me on snapchat
ok thx bro	ok thanks brother
some1	some one
something nasty asl	something nasty asl hell
bout	about
btw your acc is blocked	By The Way your account is blocked
I'm a lil shy to talk to this qt	I'm a lilttle shy to talk to this cutie
Bro plz msg me in what's app	Brother please message me in what's app
ima be waiting for u just lmk when u otw ima be waiting at the spot	I will be waiting for you just let me know when you on the way I will be waiting at the spot
pg	Parental Guidance
SH^	Shut up
I actually say that shit irl lmao	I actually say that shit in real life Laughing out loud
PTIYPASI	Put that in your pipe and smoke it
I'm saying this as if someone's gunna randomly hmu at 3:42 am lmao	I'm saying this as if someone's going to randomly hit me up at 3:42 am Laughing out loud
MRT You If you're brave nuff 2 say goodbye , life will reward u w/ a new hello	Modified ReTweet (Twitter slang) You If you're brave enough to say goodbye , life will reward you with a new hello
He was the only one who enjoyed the play, afair	He was the only one who enjoyed the play, As Far As I Remember
VEG	Very evil grin
tbh you're always on my tl and thats great ‘cause my tl is always on rock	to be honest you're always on my Timeline (twitter) and thats great because my Timeline (twitter) is always on rock
ex	former boyfriend (or girlfriend)
omg this vieos are hilarious ssif	oh my god this vieos are hilarious so stupid it's funny
WHY PUT THAT PD FACE ON MY TL	WHY PUT THAT Police department FACE ON MY Timeline (twitter)
u kno ur gonna be single 4ever	you know you are gonna be single forever
YWHNB	Yes, we have no bananas
IMA	I am a
feel me	understand me
Did you know that birds fly? Orly	Did you know that birds fly? oh really?
Correct Me If I am Wrong but r you goin out tn	Correct Me If I am Wrong but are you going out tonight 
tryna cut my nails w my fingers wbu	trying to cut my nails with my fingers what about you
if u a qt boi dm me	if you a cutie boy send direct message (on twitter) me
OMGYG2BK	Oh my God, you got to be kidding
ne1 in their right mind can see that	Anyone in their right mind can see that
OMG TQ FOR TELLINH ME THIS!	Oh my god I love you (in spanish) FOR TELLINH ME THIS!
IMCO	In My Considered Opinion
Idk how you put up w me. Thx doe	I do not know how you put up with me. Thanks though
dont be silly omg ur the cutest	dont be silly oh my god you are the cutest
they are not allowed to come 2 tc of me	they are not allowed to come to take care of me
WMMOWS	Wash My Mouth Out With Soap
M8	Mate
R8	Rate
LWOS i block so many ppl	Laughing without smiling i block so many ppl
Ima DM u his info	I will send direct message (on twitter) you his info
Wtf does this even mean like r u thick	What the fuck does this even mean like are you thick
Imma be tired asl tomorrow	I Am Going To be tired as hell tomorrow
Wth is wrong w the internet plz i have to see my bby before going to bed	What the hell is wrong with the internet please i have to see my baby before going to bed
i say fuck em all till im dead	i say fuck them all untill im dead
O	Oh
pics	pictures
u ppl will nt b able to save thm	you people will not be able to save thm
TNSTAAFL	There's no such thing as a free lunch
Idk if I’m just placebo-ing myself loti	I do not know if I’m just placebo-ing myself Laughing on the inside
I forgot my wallet in the car bbl	I forgot my wallet in the car be back later
what y'all tweeting rn is something false	what you all tweeting right now is something false
SOMY	Sick of me yet?
U choose ur decision imao	you choose your decision in my Arrogant opinion
I got to go TTFN	I got to go Bye Bye for now
YR	Your
WT	Without Thinking
Buy my trip to London pls xoxo	Buy my trip to London please Kisses and Hugs
CYA next week B4N	see you next week bye for now
W/O	Without
TYCLO	Turn Your CAPS LOCK Off (Stop Shouting)
Idk if ppl have suggested but p2p is ur best option	I donot know if people have suggested but peer to peer is your best option
tha big game iz tomorrow so BTOBD	the big game is tomorrow so Be There Or Be Dead
Idk Wth you had going on	I do not know What the hell you had going on
idk what u say but ur cute af	I do not know what you say but you are cute as fuck
I don't understand what's the BFD here	I don't understand what's the Big Frickin Deal here
NFW	No Fucking Way
cuz	because
I am going to bed now suitm	I am going to bed now See you in the morning
What a bunch of assholes, pmf	What a bunch of assholes, pardon my French
he was a sk8erboi she said see you later boi	he was a Skater Boy she said see you later boy
lol i don't kno half of the kpop stuffs on my tl now	Laughing out loud i don't know half of the korean pop stuffs on my time line now
WK	Week
FITB	Fill In The Blank
PD	Public Domain
I need a network adaptor that will fit the PCMCIA slot on my laptop	I need a network adaptor that will fit the Personal Computer Memory Card slot on my laptop
i love ur hair gal ur the one mwah	i love your hair girl you are the one kiss
be careful with your words now, you now she is hoyew	be careful with your words now, you now she is Hanging On Your Every Word
It's a BWQ	it's a Buzz Word Quotient
bak	back
NOWL	Knowledge
s/o to my co-students pls once u borrowed something pls take care of it	shout out to my co-students please once you borrowed something please take care of it
MGB	May God bless
X	Kiss
YCT	Your comment to
1c u go black u never go back	once you go black you never go back
4ur	for your
That's his lil homie lol	That's his lilttle friend Laughing out loud
wycm when you get home?	will you call me when you get home?
PLZTLME	Please tell me
I get in a rut , i feel depressed	I get in a uncomfortable situation (or place) , i feel depressed
omg nikki wow i love you thnx 4 puttin up w me all these yrs	oh my god nikki wow i love you thanks for puttin up with me all these years
FUD	Fear, Uncertainty and Doubt
PTMM	Please tell me more
IKWUM	I Know What You Mean
Have u been watching at all? IMNSHO, miracle is the reason they are bak together	Have you been watching at all? In My Not So Humble Opinion, miracle is the reason they are back together
TYFYC	Thank you for your comment
Idk y but suddenly im hearing titanic ost as backsound	I do not know why but suddenly im hearing titanic original soundtrack as backsound
not today, a friend puks for me	not today, a friend Pick up kids for me
AWHFY	Are We Having Fun Yet
wait right here, I will bbiaf	wait right here, I will be back in a few
when she ask "do I look fat?" and ut2l to answer that's a problem	when she ask "do I look fat?" and you take too long to answer that's a problem
you are the best thing ever happened to me LYSM	you are the best thing ever happened to me Love you so much
Btw wrong info. I tried it before n Not my fav	By the way wrong info. I tried it before and Not my favorite
PRW	People / parents are watching
TYAFY	Thank you and fuck you
OG	Original gangster
P2P	Peer to peer
RW	Real world
omg transl8 this 4 me plz	oh my god translate this for me please
mayb some1 cool got it	maybe some one cool got it
P911	Parents coming into room alert
Rip lil homie	rest in peace little friend
TIR	Teacher in room
H4U	Hot For You
Baby i am waiting for ur msg	Baby i am waiting for your message
living it up in the qc	living it up in the province of Quebec
Have u been watching at all? IMCO, miracle is the reason they are bak together	Have you been watching at all? In My Considered Opinion, miracle is the reason they are back together
DM ME ASAP	send direct message (on twitter) me as soon as possible
idk how to sound out words most of the time tbh	I do not know how to sound out words most of the time to be honest
Tbh I always watch with subtitles cuz I wanna eat snacks	To be honest I always watch with subtitles becuse I wanna eat snacks
RUMOF	Are you male or female
hi, my name is jessucs I'm from Queens. WAYF	hi, my name is jessucs I'm from Queens. Where are you from?
tw	twitter
RME	Rolling my eyes
imma draw rn	I am going to draw right now
UL	Upload
I'm also talking about Black Panther w my friend lmfao	I'm also talking about Black Panther with my friend Laughing out loud
NVM	Never mind
MC	Rapper
WUZ	was
Idk what he was talking bout when he made lovers and frnds lol jk jk	I do not know what he was talking about when he made lovers and friends laughing out loud just kidding just kidding
acct	account
h8	hate
Good wbu ??? Come hang out w/ me pls	Good what about you ??? Come hang out with me please
i'm following like 2 ppl now	i'm following like two people now
W3	WWW (Web address)
WTG	Way to go
btw i'm reinventing the internet guys. nbd	by the way i'm reinventing the internet guys. not big deal
TBH	To be honest
URE	your
it is a BWQ	it is a Buzz Word Quotient
i'm bored asl wyd	i'm bored as hell What are you doing?
and then he just said "tlk2ul8r gal" with a wink!	and then he just said "talk to you later girl" with a wink!
Check out the XLR8 Athletix Workout of the Day	Check out the Excelerate Athletix Workout of the Day
BYOB to my wedding	Bring Your Own Bottle to my wedding
mf	motherfucker
GF	Girlfriend
TOBAL	There Oughta Be A Law
GD&RF	Grinning, Ducking and Running Fast
YR	Year
Omg so true btw love u... ur my inspiration	Oh my god so true by the way love you... You are my inspiration
ya gal is otw to school	your girl is on the way to school
n00b	Not skilled person
LWOS	Laughing without smiling
TUI	Turning you in
CMIIW but r u goin out tn	Correct Me If I am Wrong but are you going out tonight 
let me CWYL	let me chat with you later
tbh I'm drunk af rn lol	to be honest I'm drunk as fuck right now laughing out loud
bb	baby
IMA using CPP	I am using C++ program language
2 beau rooms ready to move in! ASAP London	two beautiful rooms ready to move in! as soon as possible London
I will luv u m8	I will love you mate
I g2g TTFN	I got to go Bye Bye for now
SNERT	Snot nosed egotistical rude teenager
1c	once
I prolly say that every day lmao	I probably say that every day laughing out loud
NTW	Not To Worry
HHOK	Ha Ha Only Kidding
OTF	On the Floor (laughing)
This is total BS	This is total Bullshit
ANFSCD	And Now For Something Completely Different
RX	Regards
This is ROFL	This is Rolling on floor laughing
NSFW	Not safe for work
hhok imma fight ur ugly ass	Ha Ha Only Kidding I am going to fight your ugly ass
n	and
THIS GUY IS RLLY ADORABLE I RLLY LIKE HIM TBH	THIS GUY IS REALLY ADORABLE I REALLY LIKE HIM to be honest
Ima not very familiar w em	I am not very familiar with them
I feel sad for u guys. And I doubt abt ur eyes.	I feel sad for you guys. And I doubt about your eyes.
2 u	to you
PIP	Peeing in pants (laughing hard)
Omg im in luv with ur acct its amazin'	Oh my god im in love with your account its amazing
send me your acct number ASAP	send me your account number as soon as possible
I LYSM that it Beats The Hell Out Of Me	I love you so much that it Beats The Hell Out Of Me
They're not completely color blind afaik they can see some colors	They're not completely color blind as far as I know they can see some colors
it's usually ppl who have been shitty af , not ppl who are nice	it's usually people who have been shitty as fuck , not people who are nice
tbh this place is flooded with bs	to be honest this place is flooded with bollshit
I love it so much, it BTHOM	I love it so much, it Beats The Hell Out Of Me
ROTFL	Rolling on the floor laughing
STR8	Straight
TARFU	Things Are Really fucked Up
REHI	Hi again
LOLO	Lots of love
NVR	Never
goodmorning bitch, wyd bitch, tf bitch lmao	goodmorning bitch, what are you doing bitch, the fuck bitch laughing out loud
Tbh idk wtf is wrong with me	To be honest I do not know what the fuck is wrong with me
WH5	Who, what, when, where, why
IT ONLY TOOK 2 DAYS BEAT THAT LOSERS LMAO hhok LUV YOU GUYS	IT ONLY TOOK TWO DAYS BEAT THAT LOSERS Laughing out loud Ha Ha Only kidding LOVE YOU GUYS
fav	favorite
they say I can not do this and I say "orly"	they say I can not do this and I say "oh really?"
BBIAB	Be Back In A Bit
OMG	Oh my God
CMIIW but r u goin out tonight	Correct Me If I am Wrong but are you going out tonight 
you looks pale, ruok	you looks pale, are you okay
nite	night
PG	rude and offensive
PTO	Paid time off
SH	Same here
RFN	Right fucking now
will u msg me b4 u sleep	will you message me before you sleep
this has 2b done b4 noon	this has to be done before noon
J4F	Just For Fun
W/END	Weekend
HSIK	How Should I Know
WAN2TLK	Want to talk
KWIM	Know What I Mean
SRY	Sorry
and then we all will going to eat some pza	and then we all will going to eat some pizza
CMIIW but r u goin out 2nite	Correct Me If I am Wrong but are you going out tonight 
IIWM	If It Were Me
SDMB	Sweet dreams, my baby
Ur looking xlnt in tht dress	you are looking Excellent in that dress
lmao omg did we get away with it? n I've been stressed w/ school , wbu	laughing out loud oh my god did we get away with it? and I've been stressed with school , what about you
stfu w ur complaints , ya esp if ur not giving solutions	shut the fuck up with your complaints , yeah (yes) especially if you are not giving solutions
TTYAWFN	Talk To You A While From Now
YHBW	You have been warned
SOL	Sooner or later
HHOS	Ha Ha Only Serious
TDTM	Talk dirty to me
I lyk it cause it fit xlnt for a 1st yr guy	I like it because it fit excellent for a 1st year guy
BTOBD	Be There Or Be Dead
I C ur true colors	I see your true colors
WTB	Want to buy
NP	No problem
SIHTH	Stupidity is hard to take
argg	express anger
LOL	Laughing Out Loud
NSA	No strings attached
Tryin 2 See If Ima Get Dis Message	Trying to See If I will Get this Message
Lol idk why I read AM and not PM	Laughing Out Loud I do not know why I read AM and not PM
my valentine has a gf and plays w my heart on the daily wbu	my valentine has a girlfriend and plays w my heart on the daily what about you
I assume you know a little about the PROGGY	I assume you know a little about the computer program
don’t make such a BFD out of it	don’t make such a Big Frickin Deal out of it
hehe	laughing
TAUMUALU	Thinking about you miss you always love you
Oh damn RIP bro	Oh damn rest in peace brother
Lmfao this nigga tryna tell me I'm from south hill	Laughing out loud this black man (offensive) trying tell me I'm from south hill
VIP	Very important person
1c I wuz seven yrs old	once I was seven years old
stop growing pls ur my baby sis	stop growing please you are my baby sister
fck	fuck
W8	Wait
MOF, he did win it back in the game but gave it back right after	matter of fact, he did win it back in the game but gave it back right after
Have u been watching at all? IMAO, miracle is the reason they are bak together	Have you been watching at all? In My Arrogant Opinion, miracle is the reason they are back together
2M2H	too much to handle
PRON	pornography
Who were you with last night? Myob	Who were you with last night? Mind your own business
R u happy with the life u livin	are you happy with the life you living
FOMC	Fell Off My Chair
Y DO WHITE PPL AUDITION FOR COMPANIES LIKE YG, JYP, AND SM. Lyk tf u doing?	why DO WHITE People AUDITION FOR COMPANIES LIKE YG, JYP, AND SM. Like the fuck you doing?
LOA	List of acronyms
u think I don't care? Well… AAMOF I rly don't	u think I don't care? Well… As A Matter Of Fact I really don't
I prolly say that every day lmho	I probably say that every day laughing my head off
WRK	Work
I Cant stand when mfs wants to talk early asl in the morning	I Cant stand when motherfucker wants to talk early as hell in the morning
WDALYIC	Who died and left you in charge
pls share this acc with ur frnds	please share this account with your friends
WKD	Weekend
OMG I'M SHAKING WHILE FILMING OMG THE MC DID HIS JOB WELL	OH MY GOD I'M SHAKING WHILE FILMING OH MY GOD THE RAPPER DID HIS JOB WELL
ppl rly think pc music is rly that deep or something	people really think pc music is really that deep or something
BTAIM, I still need to have the shoes shined	Be That As It May, I still need to have the shoes shined
I hate to break it to you but, your computer is BBR	I hate to break it to you but, your computer is Broken Beyond Repair
once the new iphone finish the qc I will bought it	once the new iphone finish the Quality control I will bought it
wtf with you guys	What the fuck with you guys
SWAK	Sent with a kiss
OMG My mom is calling me for dinner so BCNU	Oh my God my mom is calling me for dinner so be seeing you
Ima in da game ova 25 yrs	I am in the game over 25 years
wtf r u talking bout	what the fuck are you talking about
justin bieber ytb ily	justin bieber you're the best I love you
CYAL8R	See You All Later
CU2	See You Too
AWGTHTGTTA?! I am too tired for this	Are We Going To Have To Go Through This Again?! I am too tired for this
UR	Your
Srsly i want to hug him he is so qt omg	Seriously i want to hug him he is so cutie oh my god
TANJ! I left the oven on	There is not Justice! I left the oven on
wat	what
NADT	Not a darn thing
NMH	Not much here
Hi how do U get a BOI to notice u without having to msg or talk to him	Hi how do you get a boy to notice you without having to message or talk to him
ily ur one of my fav	I love you you are one of my favorite
annie ruok	annie are you okay
i rly care abt you	I really care about you
faggot	gay man (offensive)
PBOOK	Phonebook (e-mail)
TANSTAAFL	There is not Such Thing As A Free Lunch
Oh yeah just a sec	Oh yeah just a second
TPM	Tomorrow PM
HT	Hi There
BION I love it	Believe it or not I love it
Did I really leave my wallet at home? fml	Did I really leave my wallet at home? fuck my life
End of the day if I get this imma be happy Asl	End of the day if I get this I am going to be happy As hell
I know some very BITTER PEOPLE , I thank GOD tht I'm not like tht at ALL	I know some very BITTER PEOPLE , I thank GOD that I'm not like that at ALL
hey we should hang out and be qt 2gethr 1 day have yr ppl call my ppl	hey we should hang out and be cutie together one day have your people call my people
Meet him FTF for once	Meet him Face to Face for once
mama u tha best lysm	mama you the best love you so much
FWIW	For What Its Worth
PROLLY	Probably
I love ANFSCD by Monty Python ssif	I love And Now For Something Completely Different by Monty Python so stupid it's funny
dat	that
WDYK	What do you know?
MOSS	Member of same sex
wait right here, I will bbiab	wait right here, I will be back in a bit
CMIIW but r u going out 2nite	Correct Me If I am Wrong but are you going out tonight 
lyk slipknot song bif	like slipknot song before I forget
Well Piers , just cuz u're not the bad guy , dz'nt make u the good guy	Well Piers , just because you are not the bad guy , does not make you the good guy
G	Giggle
i wuz SO madly in luv w the dice gal	i was SO madly in love with the dice girl
hey go on and QQ tonight	hey go on and cry tonight
irl i don't rly like 2 be called dani	in real life i don't realy like to be called dani
how much imma spend on food today lmao	how much I am going to spend on food today Laughing out loud
wudnt	would not
imco their songs r cheap	in Considered my opinion their songs are cheap
btw ily keep it up have a great day bye	by the way I love you keep it up have a great day bye
A fashion designer is a tailor thT went to school lol	A fashion designer is a tailor that went to school laughing out loud
bby	baby
Hey peeps	hey people
Only cause I sucked the battery acid out of ur power thing. Yw	Only because I sucked the battery acid out of your power thing. Your welcome
my twitter been PG til yo ass popped up lol	my twitter been rude and offensive until your ass popped up Laughing out loud
fml	fuck my life
LJBF	Let us Just Be Friends
WAJ	What a jerk
QQ	Quick question
2	too
SLM	See Last Mail
I sleep w 4 blankets bc I like to feel different ones at night wbu	I sleep with 4 blankets because I like to feel different ones at night what about you
that's has 2b amazin show!	that's has to be amazing show!
BWQ	Buzz Word Quotient
WWJD	What would Jesus do
both meanings are equally meh tbh	both meanings are equally okay (not satisfied) to be honest
nuff	enough
LMBO	Laughing out loud
txt me bak plz	text me back please
tbh I'm so disguested w the amount of cheating that goes on. If u can't be loyal u should not be in a relationship	to be honest I'm so disguested with the amount of cheating that goes on. If you can't be loyal you should not be in a relationship
stfu yr mom gay lol	Shut the fuck up your mom gay laughing out loud
KHYF	Know How You Feel
Hey govt, can I get my tax refund? Plz and thanxxx	Hey government, can I get my tax refund? Please and thanxxx
CU tomorrow bye for now	see you tomorrow bye for now
MorF	Male or female?
Correct Me If I am Wrong but r u going out tn	Correct Me If I am Wrong but are you going out tonight 
YSIC	Your sister in Christ
Correct Me If I am Wrong but r u goin out tonight	Correct Me If I am Wrong but are you going out tonight 
GIDK	Gee I Do not Know
why bother if u kno u r innocent?	why bother if you know you are innocent?
i logged my personal accounts out bc i dont like my frnds anymore lol jk	i logged my personal accounts out because i dont like my friends anymore lol just kidding
Oh my bby xoxoxo we're here for ya	Oh my baby Kisses and Hugs we're here for you
TCB	Take care of business
u got me confused for a sec lol	you got me confused for a second laughing out loud
GD&R	Grinning, Ducking and Running
U know I'm up and respond plz	you know I'm up and respond please
btw happy bday luv u	by the way happy birthday love you
hhoj ok here's the realistic version	Ha Ha Only joking ok here's the realistic version
I would not trust him with money awttw	I would not trust him with money A word to the wise
Please look @ it	Please look at it
IC	I See
imao their songs r cheap	in Arrogant my opinion their songs are cheap
coz	because
Customized TranSport XLR8 Inshore Saltwater Fishing Boat	Customized TranSport excelerate Inshore Saltwater Fishing Boat
WUU2	What are you up to
if any of u ppl want sample btw lmk	if any of you people want sample by the way let me know
wup baby gal — watching a movie w my family wbu	What's up baby girl — watching a movie with my family what about you
we had fun and then he said "sotmg" wtf?	we had fun and then he said "Short of time, must go" what the fuck?
Goodnight sis Lysm sweet dreams	Goodnight sister love you so much sweet dreams
OB	Obligatory
GLGH	Good Luck and Good Hunting
ROTFLUTS	Rolling on the floor laughing unable to speak
SH^ or QQ	Shut up or cry
ur profile pic mad cute wtf	your profile picture mad cute what the fuck
FTF	Face To Face
YNK	You never know
u are the only one who can cheer me up like that, LYLC	u are the only one who can cheer me up like that, Love you like crazy
SOTMG	Short of time, must go
I've been driving around for 20 mins. SOS	I've been driving around for 20 mins. Help
MDIAC	My Dad is a cop
SUYF	Shut up you fool
uok? I know you two where close	are you okay? I know you two where close
MB	Mamma's boy
WRT	With regard to
OMG LMAO HAHAHAHA	Oh my god Laughing out loud laughing
DK	Do not Know
Her dress Wazznt beau but seriously folks she is pretty as hell	Her dress was not beautiful but seriously folks she is pretty as hell
the acronym C&G is Used to express a light hearted laugh	the acronym Chuckle and Grin is Used to express a light hearted laugh
idk how ppl go their whole lives sober	I do not know how people go their whole lives sober
well YKW they say, Bend Over, Here It Comes Again	well you know what they say, Bend Over, Here It Comes Again
Idk what yall think abt me	I do not know what you all think about me
dont skip ur meds / change it w/o doctor's advise	dont skip your meds / change it without doctor's advise
TANKED	Owned
cause	because
FTL	Faster Than Light
UFN	Until further notice
WAEF	When All Else Fails
plz look at it	Please look at it
how bad u think they r lol they don't look bad to me but ima dude what do I know	how bad you think they are Laughing Out Loud they don't look bad to me but I am a dude what do I know
They're basically the same AFAIK	They are basically the same as far as I know
MLA	Multiple Letter Acronym
SSIF	So stupid it's funny
TFTI	Thanks for the invitation
I love the feeling of cleaning my ears with a Q-tips, I fucking mfi	I love the feeling of cleaning my ears with a Q-tips, I fucking mad for it
nm nm just on a date w my gal , showing her the finer things u know , wbu?	nothing much nothing much just on a date with my girl , showing her the finer things you know , what about you?
Correct Me If I am Wrong but r you going out tonight	Correct Me If I am Wrong but are you going out tonight 
What are the odds that 3 out of the 4 ppl I msg all wake up at the same time LOL	What are the odds that 3 out of the 4 people I message all wake up at the same time Laughing out loud
IT ONLY TOOK 2 DAYS HAHAHAHAH BEAT THAT LOSERS LMAO JK JK LUV YOU GUYS	IT ONLY TOOK TWO DAYS laughing BEAT THAT LOSERS Laughing out loud Just Kidding Just Kidding LOVE YOU GUYS
JMO	Just My Opinion
WYSIWYG	What you see is what you get
coming to stay w me this weekend and y'all best believe we're fixin to b right back on our bs!!!	coming to stay with me this weekend and you all best believe we're fixin to be right back on our bullshit!!!
LYLC	Love you like crazy
bs	bullshit
tbh I prefer my hybrid railgun but YMMV	to be honest I prefer my hybrid railgun but Your mileage may vary
MIRL	Meet in real life
i think im done w ur hair so now we gotta w8 for the pretty pink bb	i think im done with your hair so now we gotta wait for the pretty pink baby
yrw very much	You are welcome very much
WTF i leave twitter when plu were common… nvm	What The Fuck i leave twitter when people like us were common… never mind
NFS	No funny shit
AAMOF	As A Matter Of Fact
This pic omg ...	This picture oh my god ...
the big game iz tomorrow so Be There Or Be Dead	the big game is tomorrow so Be There Or Be Dead
So did someone msg you? R u gay?	So did someone message you? are you gay?
yes pls let us dm i rly wanna be ur friend	yes please let us send direct message (on twitter) i really wanna be your friend
Who were you with last night? Myo	Who were you with last night? Mind your own business
he sent a pic w/ his frands	he sent a picture with his friends
CU tomorrow BBFN	see you tomorrow bye bye for now
YKWYCD	You know what you can do
OMG My mom is calling me for dinner so BCNU later	Oh my God my mom is calling me for dinner so be seeing you later
WTF HAHAHAHA i am laughing so much yg love the ass licking	What The Fuck laughing i am laughing so much young gangster love the ass licking
ADN	Any Day Now
TWSS	That's what she said
SBT	Sorry about that
omg I'm having dinner right now and the next stall is playing the best ost ever	oh my god I'm having dinner right now and the next stall is playing the best original soundtrack ever
phone dry asl some1 txt me	phone dry as hell some one text me
OWTTE	Or Words To That Effect
btw so many ppl using it bc of the new friend finder	by the way so many people using it because of the new friend finder
Idk what shes doing tbh	I do not know what shes doing to be honest
2b	to be
g2g BFN	got to go Bye for now
CMIIW but r you going out tonight	Correct Me If I am Wrong but are you going out tonight 
how am i? well, nino	how am i? well, Nothing In, Nothing Out